α	α
ℓ	ℓ
①	①
②	②
③	③
④	④
⑤	⑤
⑥	⑥
⑦	⑦
⑧	⑧
⑨	⑨
⑩	⑩
⑪	⑪
⑫	⑫
⑬	⑬
⑭	⑭
⑮	⑮
⑯	⑯
⑲	⑲
△	△
⺀	丶
⺄	⺄
⺆	⺆
⺊	⺊
⺌	⺌
⺸	干	艹
⺻	一	肀
⺼	⺆	冫
〢	丨
い	い
よ	よ
り	り
コ	コ
サ	サ
ス	ス
ユ	ユ
㇀	㇀
㇇	㇇
㇉	㇉
㇋	㇋
㇌	㇌
㇍	㇍
㇎	㇎
㇓	㇓
㇞	㇞
㇢	㇢
㇣	㇣
一	一
丁	一	亅
丂	㇉	一
七	㇀	乚
丄	一	丨
丅	一	丨
丆	一	丿
万	一	丿	𠃌
丈	丈
三	一	二
上	⺊	一
下	一	卜
丌	一	丨	丿
不	③	一
与	②	一
丏	丏
丐	丐
丑	丑
丒	一	刃
专	专
且	且
丕	一	不
世	世
丗	丨	廿
丘	丘
丙	一	内
业	④	一
丛	一	从
东	东
丝	②	一
丞	一	氶
丟	厶	王
丠	一	北
両	一	冂	山
丢	丿	去
丣	丣
两	一	从	冂
严	④	一	厂
並	䒑	业
丧	丷	丿	乀	土	𠄌
丨	丨
丩	丩
个	丨	人
丫	丨	丷
丬	丬
中	丨	口
丮	⺄	丨	二
丯	丨	彡
丰	三	丨
丱	丱
串	丨	吕
丳	丨	丿	吕
临	〢	丶	𠂉	𫩏
丵	业	𢆉
丶	丶
丷	丷
丸	丶	九
丹	丹
为	为
主	亠	土
丼	丶	井
丽	一	丶	冂
举	丨	二	兴
丿	丿
乀	乀
乁	乁
乂	丿	乀
乃	丿	𠄎
乄	乄
久	久
乆	乀	𠂈
乇	七	丿
么	丿	厶
义	丶	乂
乊	丷	丿
之	②	丶
乌	③	一
乍	乍
乎	乎
乏	丿	之
乐	乐
乑	乑
乒	丘	丿
乓	丘	丶
乔	丨	丿	夭
乕	丨	二	冂	𠂆
乖	北	千
乗	乗
乘	北	禾
乙	乙
乚	乚
乛	乛
乜	乜
九	九
乞	乙	𠂉
也	也
习	冫	𠃌
乡	乡
乢	乚	山
乣	乚	幺
乤	下	乙
乥	乊	乙
书	书
乧	乙	斗
乨	乚	台
乩	乚	占
乪	乙	田
乫	乙	加
乬	乙	巨
乭	乙	石
乮	乙	卯
乯	乎	乙
买	乛	头
乱	乚	舌
乲	乙	次
乳	乚	孚
乴	乙	折
乵	乚	辛
乶	乙	甫
乷	乙	沙
乸	也	母
乹	乚	𠦝
乺	乙	所
乻	乙	於
乼	乙	注
乽	乙	者
乾	乞	𠦝
乿	乚	爫	糸
亀	日	电	𠂊
亁	乞	十	旱
亂	乚	𤔔
亃	乚	粦
亄	乚	壹
亅	亅
了	乛	亅
亇	亅	𠂊
予	龴	𠄐
争	コ	一	亅	𠂊
亊	亊
事	事
二	一
亍	一	丁
于	于
亏	一	丂
亐	一	𠀁
云	二	厶
互	一	彑
亓	一	丌
五	一	𫝀
井	井
亖	二
亗	二	山
亘	一	旦
亙	④	一
亚	一	业
些	二	此
亜	亜
亝	二	厽
亞	⑥	一
亟	一	了	叹
亠	一	丶
亡	亠	𠃊
亢	亠	几
亣	丌	丶
交	亠	父
亥	亠	人	𠂈
亦	④	亠
产	丷	亠	厂
亨	了	亠	口
亩	亠	田
亪	乁	亦
享	亠	口	子
京	亠	口	小
亭	丁	亠	冖	口
亮	亠	冖	几	口
亯	亠	口	日
亰	亠	小	日
亱	亠	但
亲	朩	立
亳	乇	亠	冖	口
亴	九	亠	冖	口	土
亵	亠	执	𧘇
亶	㐭	旦
亷	④	コ	一	产
亸	享	单
亹	亠	舋
人	人
亻	亻
亼	一	人
亽	丶	人
亾	人	𠃊
亿	乙	亻
什	亻	十
仁	二	亻
仂	亻	力
仃	丁	亻
仄	人	厂
仅	亻	又
仆	亻	卜
仇	九	亻
仈	亻	八
仉	亻	几
今	㇇	亽
介	丨	丿	人
仌	人
仍	乃	亻
从	人
仏	亻	厶
仐	人	十
仑	人	匕
仒	⺀	人
仓	㔾	人
仔	亻	子
仕	亻	士
他	也	亻
仗	丈	亻
付	亻	寸
仙	亻	山
仚	人	山
仛	乇	亻
仜	亻	工
仝	人	工
仞	亻	刃
仟	亻	千
仠	亻	干
仡	乞	亻
仢	亻	勺
代	亻	弋
令	亽	龴
以	以
仦	亻	小
仧	上	人
仨	三	亻
仩	上	亻
仪	义	亻
仫	么	亻
们	亻	门
仭	亻	刄
仮	亻	反
仯	亻	少
仰	亻	卬
仱	亻	今
仲	中	亻
仳	亻	比
仴	亻	月
仵	亻	午
件	亻	牛
价	亻	介
仸	亻	夭
仹	丰	亻
仺	一	人	匚
任	亻	壬
仼	亻	王
份	亻	分
仾	互	亻
仿	亻	方
伀	亻	公
企	人	止
伂	亻	巿
伃	予	亻
伄	亻	弔
伅	亻	屯
伆	亻	勿
伇	亻	殳
伈	亻	心
伉	亢	亻
伊	亻	尹
伋	亻	及
伌	亻	厄
伍	五	亻
伎	亻	支
伏	亻	犬
伐	亻	戈
休	亻	木
伒	亻	斤
伓	不	亻
伔	亻	冗
伕	亻	夫
伖	亻	友
众	人	从
优	亻	尤
伙	亻	火
会	云	人
伛	亻	区
伜	亻	卆
伝	云	亻
伞	丷	人	十
伟	亻	韦
传	专	亻
伡	亻	车
伢	亻	牙
伣	亻	见
伤	亻	力	𠂉
伥	亻	长
伦	亻	仑
伧	亻	仓
伨	亻	匀
伩	亻	文
伪	为	亻
伫	㝉	亻
伬	亻	尺
伭	亻	玄
伮	亻	奴
伯	亻	白
估	亻	古
伱	亻	尒
伲	亻	尼
伳	世	亻
伴	亻	半
伵	亻	四
伶	亻	令
伷	亻	由
伸	亻	申
伹	且	亻
伺	亻	司
伻	亻	平
似	亻	以
伽	亻	加
伾	丕	亻
伿	亻	只
佀	㠯	亻
佁	亻	台
佂	亻	正
佃	亻	田
佄	亻	甘
佅	亻	未
但	亻	旦
佇	亻	宁
佈	亻	布
佉	亻	去
佊	亻	皮
佋	亻	召
佌	亻	此
位	亻	立
低	亻	氐
住	主	亻
佐	亻	左
佑	亻	右
佒	亻	央
体	亻	本
佔	亻	占
何	亻	可
佖	亻	必
佗	亻	它
佘	人	示
余	亼	朩
佚	亻	失
佛	亻	弗
作	乍	亻
佝	亻	句
佞	亻	𡚬
佟	亻	冬
你	亻	尔
佡	亻	仚
佢	亻	巨
佣	亻	用
佤	亻	瓦
佥	一	亼	𭕄
佦	亻	石
佧	亻	卡
佨	亻	包
佩	亻	𫥞
佪	亻	回
佫	亻	各
佬	亻	老
佭	亻	夅
佮	亻	合
佯	亻	羊
佰	亻	百
佱	亼	正
佲	亻	名
佳	亻	圭
佴	亻	耳
併	亻	并
佶	亻	吉
佷	亻	艮
佸	亻	舌
佹	亻	危
佺	亻	全
佻	亻	兆
佼	交	亻
佽	亻	次
佾	䏌	亻
使	亻	吏
侀	亻	刑
侁	亻	先
侂	㡯	亻
侃	亻	口	𫶧
侄	亻	至
侅	亥	亻
來	从	木
侇	亻	夷
侈	亻	多
侉	亻	夸
侊	亻	光
例	亻	列
侌	云	今
侍	亻	寺
侎	亻	米
侏	亻	朱
侐	亻	血
侑	亻	有
侒	亻	安
侓	亻	聿
侔	亻	牟
侕	亻	而
侖	亼	𠕁
侗	亻	同
侘	亻	宅
侙	亻	式
侚	亻	旬
供	亻	共
侜	亻	舟
依	亻	衣
侞	亻	如
侟	亻	存
侠	亻	夹
価	亻	覀
侢	亻	再
侣	亻	吕
侤	亻	考
侥	亻	尧
侦	亻	贞
侧	亻	则
侨	乔	亻
侩	亻	会
侪	亻	齐
侫	亻	妄
侬	亻	农
侭	亻	尽
侮	亻	每
侯	ユ	亻	矢
侰	亻	君
侱	亻	呈
侲	亻	辰
侳	亻	坐
侴	丑	亼	刂
侵	亻	𠬶
侶	亻	呂
侷	亻	局
侸	亻	豆
侹	亻	廷
侺	亻	岑
侻	亻	兑
侼	亻	孛
侽	亻	男
侾	亻	孝
便	亻	更
俀	亻	妥
俁	亻	吳
係	亻	系
促	亻	足
俄	亻	我
俅	亻	求
俆	亻	余
俇	亻	狂
俈	亻	告
俉	亻	吾
俊	亻	夋
俋	亻	邑
俌	亻	甫
俍	亻	良
俎	且	仌
俏	亻	肖
俐	亻	利
俑	亻	甬
俒	亻	完
俓	亻	巠
俔	亻	見
俕	亻	宋
俖	亻	否
俗	亻	谷
俘	亻	孚
俙	亻	希
俚	亻	里
俛	亻	免
俜	亻	甹
保	亻	呆
俞	亼	刖
俟	亻	矣
俠	亻	夾
信	亻	言
俢	亻	夂	彡
俣	亻	吴
俤	亻	弟
俥	亻	車
俦	亻	寿
俧	亻	志
俨	严	亻
俩	两	亻
俪	丽	亻
俫	亻	来
俬	亻	私
俭	亻	佥
修	丨	亻	夂	彡
俯	亻	府
俰	亻	和
俱	亻	具
俲	亻	効
俳	亻	非
俴	亻	戔
俵	亻	表
俶	亻	叔
俷	亻	肥
俸	亻	奉
俹	亞	亻
俺	亻	奄
俻	亻	备
俼	亻	育
俽	亻	欣
俾	亻	卑
俿	亻	虎
倀	亻	長
倁	亻	知
倂	亻	幷
倃	亻	咎
倄	亻	肴
倅	亻	卒
倆	亻	兩
倇	亻	宛
倈	亻	來
倉	一	亽	口	尸
倊	亻	忩
個	亻	固
倌	亻	官
倍	亻	咅
倎	亻	典
倏	丨	亻	夂	犬
倐	丨	亻	夂	火
們	亻	門
倒	亻	到
倓	亻	炎
倔	亻	屈
倕	亻	垂
倖	亻	幸
倗	亻	朋
倘	亻	尚
候	ユ	丨	亻	矢
倚	亻	奇
倛	亻	其
倜	亻	周
倝	人	𠦝
倞	京	亻
借	亻	昔
倠	亻	隹
倡	亻	昌
倢	亻	疌
倣	亻	放
値	亻	直
倥	亻	空
倦	亻	卷
倧	亻	宗
倨	亻	居
倩	亻	青
倪	亻	兒
倫	亻	侖
倬	亻	卓
倭	亻	委
倮	亻	果
倯	亻	松
倰	亻	夌
倱	亻	昆
倲	亻	東
倳	事	亻
倴	亻	奔
倵	亻	武
倶	亻	具
倷	亻	奈
倸	亻	采
倹	㑒	亻
债	亻	责
倻	亻	耶
值	亻	直
倽	亻	舍
倾	亻	顷
倿	亻	妾
偀	亻	英
偁	亻	爯
偂	亻	前
偃	亻	匽
偄	亻	耎
偅	亻	重
偆	亻	春
假	亻	叚
偈	亻	曷
偉	亻	韋
偊	亻	禹
偋	亻	屏
偌	亻	若
偍	亻	是
偎	亻	畏
偏	亻	扁
偐	亻	彦
偑	亻	風
偒	亻	昜
偓	亻	屋
偔	亻	咢
偕	亻	皆
偖	亻	者
偗	亻	省
偘	亻	品
偙	亻	帝
做	亻	故
偛	亻	臿
停	亭	亻
偝	亻	背
偞	亻	枼
偟	亻	皇
偠	亻	要
偡	亻	甚
偢	亻	秋
偣	亻	音
偤	亻	酋
健	亻	建
偦	亻	胥
偧	亻	奓
偨	亻	柴
偩	亻	負
偪	亻	畐
偫	亻	待
偬	亻	怱
偭	亻	面
偮	亻	咠
偯	亻	哀
偰	亻	契
偱	亻	盾
偲	亻	思
偳	亻	耑
側	亻	則
偵	亻	貞
偶	亻	禺
偷	亻	俞
偸	亻	兪
偹	丨	亻	备
偺	亻	昝
偻	亻	娄
偼	⺊	コ	一	亻	龰
偽	亻	為
偾	亻	贲
偿	亻	尝
傀	亻	鬼
傁	亻	叟
傂	亻	虒
傃	亻	素
傄	亻	眘
傅	亻	尃
傆	亻	原
傇	亻	茸
傈	亻	栗
傉	亻	辱
傊	亻	員
傋	亻	冓
傌	亻	馬
傍	亻	旁
傎	亻	真
傏	亻	唐
傐	亻	高
傑	亻	桀
傒	亻	奚
傓	亻	扇
傔	亻	兼
傕	亻	隺
傖	亻	倉
傗	亻	畜
傘	人	十	𠈌
備	亻	𤰇
傚	亻	效
傛	亻	容
傜	䍃	亻
傝	亻	𦐇
傞	亻	差
傟	亻	翁
傠	亻	討
傡	亻	竝
傢	亻	家
傣	亻	泰
傤	亻	载
傥	亻	党
傦	亻	骨
傧	亻	宾
储	亻	诸
傩	亻	难
傪	亻	參
傫	亻	累
催	亻	崔
傭	亻	庸
傮	亻	曹
傯	亻	悤
傰	亻	崩
傱	亻	從
傲	亻	敖
傳	亻	專
傴	亻	區
債	亻	責
傶	亻	戚
傷	亻	𬀷
傸	亻	爽
傹	亻	竟
傺	亻	祭
傻	亻	𡕩
傼	亻	口	夫	廿
傽	亻	章
傾	亻	頃
傿	亻	焉
僀	亻	帶
僁	亻	悉
僂	亻	婁
僃	亻	勹	用	艹
僄	亻	票
僅	亻	堇
僆	亻	連
僇	亻	翏
僈	亻	曼
僉	亼	从	吅
僊	䙲	亻	巳
僋	亻	貪
僌	亻	𨊴
働	亻	動
僎	亻	巽
像	亻	象
僐	亻	善
僑	亻	喬
僒	亻	窘
僓	亻	貴
僔	亻	尊
僕	亻	菐
僖	亻	喜
僗	亻	勞
僘	亻	敞
僙	亻	黄
僚	亻	尞
僛	亻	欺
僜	亻	登
僝	亻	孱
僞	亻	爲
僟	亻	幾
僠	亻	番
僡	亻	惠
僢	亻	舜
僣	亻	替
僤	亻	單
僥	亻	堯
僦	亻	就
僧	亻	曾
僨	亻	賁
僩	亻	閒
僪	亻	矞
僫	亻	惡
僬	亻	焦
僭	亻	朁
僮	亻	童
僯	亻	粦
僰	人	棘
僱	亻	雇
僲	亻	舛	覀
僳	亻	粟
僴	亻	間
僵	亻	畺
僶	亻	黽
僷	亻	葉
僸	亻	禁
價	亻	賈
僺	亻	喿
僻	亻	辟
僼	亻	豊
僽	亻	愁
僾	亻	愛
僿	亻	塞
儀	亻	義
儁	亻	雋
儂	亻	農
儃	亶	亻
億	亻	意
儅	亻	當
儆	亻	敬
儇	亻	睘
儈	亻	會
儉	亻	僉
儊	亻	楚
儋	亻	詹
儌	亻	敫
儍	亻	𡕰
儎	亻	載
儏	亻	粲
儐	亻	賓
儑	㬎	亻
儒	亻	需
儓	亻	臺
儔	亻	壽
儕	亻	齊
儖	亻	監
儗	亻	疑
儘	亻	盡
儙	亻	遣
儚	亻	夢
儛	亻	舞
儜	亻	寧
儝	亻	榮
儞	亻	爾
償	亻	賞
儠	亻	巤
儡	亻	畾
儢	亻	慮
儣	亻	廣
儤	亻	暴
儥	亻	賣
儦	亻	麃
儧	亻	賛
儨	亻	質
儩	亻	賜
優	亻	憂
儫	亻	豪
儬	亻	靚
儭	亻	親
儮	亻	歷
儯	亻	駦
儰	亻	蔿
儱	亻	龍
儲	亻	諸
儳	亻	毚
儴	亻	襄
儵	丨	亻	夂	黑
儶	亻	巂
儷	亻	麗
儸	亻	羅
儹	亻	贊
儺	亻	難
儻	亻	黨
儼	亻	嚴
儽	亻	纍
儾	亻	囊
儿	丿	乚
兀	一	儿
允	儿	厶
兂	兂
元	一	兀
兄	儿	口
充	儿	𠫓
兆	兆
兇	儿	凶
先	儿	𠂒
光	⺌	兀
兊	儿	公
克	儿	古
兌	兄	八
免	⑤	𠂊
兎	⑤	丶	丿
兏	厂	𠑷
児	儿	旧
兑	丷	兄
兒	儿	臼
兓	旡
兔	丶	免
兕	儿	凹
兖	亠	兊
兗	亠	兌
兘	元	台
兙	克	十
党	兄	龸
兛	克	千
兜	②	コ	儿	白
兝	克	分
兞	克	毛
兟	先
兠	儿	北	白
兡	克	百
兢	克
兣	克	厘
兤	光	廣
入	入
兦	入	𠃊
內	入	冂
全	人	王
兩	一	巾	𠓜
兪	亼	巜	月
八	八
公	八	厶
六	亠	八
兮	丂	八
兯	丨	丷	𠃌
兰	三	丷
共	八	龷
兲	八	王
关	丷	天
兴	一	八	𭕄
兵	丘	八
其	⑤	一	八
具	一	且	八
典	⑥	八
兹	䒑	𢆶
兺	分	叱
养	䒑	丨	丿	夫
兼	④	コ	䒑	一
兽	一	口	𬎿
兾	丷	異
兿	䒑	云	执
冀	北	異
冁	单	展
冂	冂
冃	二	冂
冄	二	冂
内	人	冂
円	円
冇	冂	𠂇
冈	㐅	冂
冉	冉
冊	一	𦉫
冋	冂	口
册	册
再	一	冉
冎	冂	𠃍
冏	㕣	冂
冐	冃	月
冑	冃	由
冒	冃	目
冓	冉	𠀎
冔	冃	吁
冕	免	冃
冖	冖
冗	冖	几
冘	冘
写	与	冖
冚	冖	山
军	冖	车
农	冖	𧘇
冝	且	冖
冞	冖	米
冟	冖	皀
冠	㝴	冖
冡	一	冖	豕
冢	冖	豖
冣	冖	取
冤	兔	冖
冥	冖	昗
冦	元	冖	攴
冧	冖	林
冨	冖	畐
冩	冖	舄
冪	冖	幕
冫	冫
冬	⺀	夂
冭	⺀	大
冮	冫	工
冯	冫	马
冰	冫	水
冱	互	冫
冲	中	冫
决	冫	夬
冴	冫	牙
况	兄	冫
冶	冫	台
冷	令	冫
冸	冫	半
冹	冫	犮
冺	冫	民
冻	东	冫
冼	先	冫
冽	冫	列
冾	冫	合
冿	冫	聿
净	争	冫
凁	冫	束
凂	免	冫
凃	余	冫
凄	冫	妻
凅	冫	固
准	冫	隹
凇	冫	松
凈	冫	爭
凉	京	冫
凊	冫	青
凋	冫	周
凌	冫	夌
凍	冫	東
凎	冫	金
减	冫	咸
凐	冫	垔
凑	冫	奏
凒	冫	豈
凓	冫	栗
凔	倉	冫
凕	冥	冫
凖	准	十
凗	冫	崔
凘	冫	斯
凙	冫	睪
凚	冫	禁
凛	冫	禀
凜	冫	稟
凝	冫	疑
凞	冫	熈
凟	冫	賣
几	几
凡	丶	几
凢	丿	几
凣	丨	几
凤	几	又
凥	几	尸
処	几	夂
凧	几	巾
凨	云	几
凩	几	木
凪	几	止
凫	④	几
凬	几	𣄼
凭	任	几
凮	几	百
凯	几	岂
凰	几	皇
凱	几	豈
凲	兼	几
凳	几	登
凴	几	馮
凵	凵
凶	㐅	凵
凷	凵	土
凸	凸
凹	凹
出	凵	屮
击	丨	二	凵
凼	凵	水
函	丷	了	八	凵
凾	了	凵	叹
凿	丵	凵
刀	丿	𠃌
刁	㇀	𠃌
刂	刂
刃	丿	刀
刄	乀	刀
刅	丶	刃
分	八	刀
切	七	刀
刈	㐅	刂
刉	乞	刂
刊	刂	干
刋	刂	千
刌	刂	寸
刍	彐	𠂊
刎	刂	勿
刏	刂	气
刐	丹	刂
刑	刂	开
划	刂	戈
刓	元	刂
刔	刂	夬
刕	刀	𠚪
刖	刂	月
列	刂	歹
刘	刂	文
则	刂	贝
刚	冈	刂
创	仓	刂
刜	刂	弗
初	刀	衤
刞	且	刂
刟	刂	召
删	册	刂
刡	刂	民
刢	令	刂
刣	刂	台
判	刂	半
別	刂	𠮠
刦	刂	去
刧	刀	去
刨	刂	包
利	刂	禾
刪	冊	刂
别	刂	另
刬	刂	戋
刭	刂	𢀖
刮	刂	舌
刯	亘	刂
到	刂	至
刱	井	刅
刲	刂	圭
刳	刂	夸
刴	刂	朶
刵	刂	耳
制	冂	刂	牛
刷	刂	𡰯
券	刀	龹
刹	刂	杀
刺	刂	朿
刻	亥	刂
刼	刃	去
刽	会	刂
刾	刂	夹
刿	刂	岁
剀	刂	岂
剁	刂	朵
剂	刂	齐
剃	刂	弟
剄	刂	巠
剅	刂	豆
剆	⑤	丶	刂
則	刂	貝
剈	刂	肙
剉	刂	坐
削	刂	肖
剋	克	刂
剌	刂	束
前	䒑	刖
剎	刂	𣏂
剏	刃	并
剐	刂	呙
剑	佥	刂
剒	刂	昔
剓	刀	𥝢
剔	刂	易
剕	刂	非
剖	刂	咅
剗	刂	戔
剘	其	刂
剙	刅	并
剚	事	刂
剛	刂	岡
剜	刂	宛
剝	刂	彔
剞	刂	奇
剟	刂	叕
剠	京	刂
剡	刂	炎
剢	刂	豖
剣	㑒	刂
剤	刂	斉
剥	刂	录
剦	刂	奄
剧	刂	居
剨	刂	砉
剩	乘	刂
剪	刀	前
剫	刂	度
剬	刂	耑
剭	刂	屋
剮	刂	咼
副	刂	畐
剰	乗	刂
剱	㑒	刃
割	刂	害
剳	刂	荅
剴	刂	豈
創	倉	刂
剶	刂	彖
剷	刂	産
剸	刂	專
剹	刂	翏
剺	刀	𠩺
剻	刂	崩
剼	刂	參
剽	刂	票
剾	刂	區
剿	刂	巢
劀	刂	矞
劁	刂	焦
劂	刂	厥
劃	刂	畫
劄	刂	答
劅	刂	蜀
劆	刂	廉
劇	刂	豦
劈	刀	辟
劉	③	刀	刂	金
劊	刂	會
劋	刂	喿
劌	刂	歲
劍	僉	刂
劎	僉	刀
劏	刂	當
劐	刂	蒦
劑	刂	齊
劒	僉	刃
劓	刂	鼻
劔	僉	刄
劕	刂	質
劖	刂	毚
劗	刂	贊
劘	刂	靡
劙	刂	蠡
劚	刂	屬
力	丿	𠃌
劜	乚	力
劝	力	又
办	八	力
功	力	工
加	力	口
务	力	夂
劢	万	力
劣	力	少
劤	力	斤
劥	亢	力
劦	力	𠠴
劧	力	手
动	云	力
助	且	力
努	力	奴
劫	力	去
劬	力	句
劭	力	召
劮	力	失
劯	力	石
劰	力	白
励	力	厉
劲	力	𢀖
劳	力	𫇦
労	冖	力	𭕄
劵	力	龹
劶	力	后
劷	力	羊
劸	力	圭
効	交	力
劺	力	牟
劻	力	匡
劼	力	吉
劽	列	力
劾	亥	力
势	力	执
勀	克	力
勁	力	巠
勂	力	告
勃	力	孛
勄	力	每
勅	力	束
勆	⑤	丶	力
勇	力	甬
勈	力	甬
勉	免	力
勊	克	力
勋	力	员
勌	力	卷
勍	京	力
勎	力	坴
勏	力	咅
勐	力	孟
勑	來	力
勒	力	革
勓	力	皆
勔	力	面
動	力	重
勖	冒	力
勗	助	日
勘	力	甚
務	务	矛
勚	力	贳
勛	力	員
勜	力	翁
勝	劵	月
勞	力	𤇾
募	力	莫
勠	力	翏
勡	力	票
勢	力	埶
勣	力	責
勤	力	堇
勥	力	強
勦	力	巢
勧	力	𮥶
勨	力	象
勩	力	貰
勪	力	喬
勫	力	番
勬	力	絭
勭	力	童
勮	力	豦
勯	亶	力
勰	劦	思
勱	力	萬
勲	動	灬
勳	力	熏
勴	力	慮
勵	力	厲
勶	力	徹
勷	力	襄
勸	力	雚
勹	勹
勺	丶	勹
勻	二	勹
勼	九	勹
勽	人	勹
勾	勹	厶
勿	丿	勹
匀	冫	勹
匁	乂	勹
匂	勹	匕
匃	亾	勹
匄	亡	勹
包	勹	巳
匆	丶	勿
匇	勹	夕
匈	凶	勹
匉	勹	平
匊	勹	米
匋	勹	缶
匌	勹	合
匍	勹	甫
匎	勹	奄
匏	包	夸
匐	勹	畐
匑	勹	躬
匒	勹	荅
匓	⑤	勹	殳
匔	勹	躳
匕	丿	乚
化	亻	𠤎
北	③	匕
匘	匕	𡿺
匙	匕	是
匚	匚
匛	久	匚
匜	也	匚
匝	匚	巾
匞	匚	工
匟	亢	匚
匠	匚	斤
匡	匚	王
匢	勿	匚
匣	匚	甲
匤	匚	玉
匥	匚	弁
匦	匚	轨
匧	匚	夾
匨	匚	壯
匩	匚	𡉚
匪	匚	非
匫	匚	曶
匬	俞	匚
匭	匚	軌
匮	匚	贵
匯	匚	淮
匰	匚	單
匱	匚	貴
匲	匚	𡙗
匳	僉	匚
匴	匚	算
匵	匚	賣
匶	匚	舊
匷	匚	瞿
匸	匸
匹	儿	匚
区	㐅	匚
医	匚	矢
匼	匚	合
匽	匚	妟
匾	匚	扁
匿	匚	若
區	匚	品
十	十
卂	⺄	十
千	丿	十
卄	丨	十
卅	一	川
卆	九	十
升	丿	廾
午	十	𠂉
卉	十	廾
半	丨	丷	二
卋	十	廿
卌	卌
卍	卍
华	化	十
协	办	十
卐	卐
卑	丿	十	白
卒	十	𠅃
卓	⺊	早
協	劦	十
单	一	丷	甲
卖	买	十
南	冂	十	𢆉
単	一	甲	𭕄
卙	十	甚
博	十	尃
卛	䜌	十
卜	卜
卝	卝
卞	下	丶
卟	卜	口
占	⺊	口
卡	上	卜
卢	⺊	尸
卣	⺊	囙
卤	⺊	龱
卥	⺊	丶	丿	囗
卦	卜	圭
卧	卜	臣
卨	⺊	咼
卩	卩
卪	丶	卩
卫	一	丨	𠃌
卬	②	卩
卭	卩	工
卮	㔾	𠂋
卯	卩	𠂎
印	③	卩
危	㔾	厃
卲	卩	召
即	⑤	卩
却	卩	去
卵	卪	𠂑
卶	卩	多
卷	㔾	龹
卸	卩	𦈢
卹	卩	血
卺	㔾	丞
卻	卩	谷
卼	兀	危
卽	卩	皀
卾	卩	咢
卿	⑤	卩	𠂎
厀	卩	桼
厁	卩	斜
厂	厂
厃	厂	𠂊
厄	㔾	厂
厅	丁	厂
历	力	厂
厇	乇	厂
厈	厂	干
厉	万	厂
厊	厂	牙
压	厂	圡
厌	厂	犬
厍	厂	车
厎	厂	氐
厏	乍	厂
厐	厂	龙
厑	厂	叱
厒	厂	缶
厓	厂	圭
厔	厂	至
厕	则	厂
厖	厂	尨
厗	厂	辛
厘	厂	里
厙	厂	車
厚	㫗	厂
厛	厂	听
厜	厂	垂
厝	厂	昔
厞	厂	非
原	厂	小	白
厠	則	厂
厡	厂	泉
厢	厂	相
厣	厌	甲
厤	厂	秝
厥	厂	欮
厦	厂	夏
厧	厂	真
厨	厂	𭔰
厩	厂	既
厪	厂	堇
厫	厂	敖
厬	厂	晷
厭	厂	猒
厮	厂	斯
厯	丶	乚	𠩵
厰	厂	敞
厱	僉	厂
厲	厂	萬
厳	𠪚	𭕄
厴	厭	甲
厵	原
厶	厶
厷	厶	𠂇
厸	厶
厹	九	厶
厺	厶	大
去	厶	土
厼	厶	小
厽	厶	厸
厾	⺄	去
县	且	厶
叀	厶	𤰔
叁	三	厶	大
参	厶	大	彡
參	彡	𠫯
叄	三	𠫯
叅	㣺	𠫯
叆	云	爱
叇	云	逮
又	又
叉	丶	又
及	及
友	又	𠂇
双	又
反	又	𠂆
収	丩	又
叏	ユ	丨	又
叐	丿	友
发	发
叒	又	双
叓	一	中	又
叔	又	尗
叕	双
取	又	耳
受	冖	又	爫
变	亦	又
叙	余	又
叚	⑤	コ	又
叛	半	反
叜	宀	𤆌
叝	去	𠬝
叞	又	𫵖
叟	丨	又	臼
叠	冝	叒
叡	又	睿
叢	丵	取
口	口
古	十	口
句	勹	口
另	力	口
叧	刀	口
叨	刀	口
叩	卩	口
只	八	口
叫	丩	口
召	刀	口
叭	八	口
叮	丁	口
可	丁	口
台	厶	口
叱	口	𠤎
史	史
右	口	𠂇
叴	九	口
叵	匚	口
叶	十	口
号	丂	口
司	𠃌	𠮛
叹	又	口
叺	入	口
叻	力	口
叼	刁	口
叽	几	口
叾	了	口
叿	口	工
吀	千	口
吁	于	口
吂	亡	口
吃	乞	口
各	口	夂
吅	口
吆	口	幺
吇	口	子
合	亼	口
吉	口	士
吊	口	巾
吋	口	寸
同	口	𠔼
名	口	夕
后	口	𠂋
吏	一	史
吐	口	土
向	丿	冂	口
吒	乇	口
吓	下	口
吔	也	口
吕	口
吖	丫	口
吗	口	马
吘	午	口
吙	口	火
吚	口	尹
君	口	尹
吜	丑	口
吝	口	文
吞	口	天
吟	今	口
吠	口	犬
吡	口	比
吢	口	心
吣	口	心
吤	介	口
吥	不	口
否	不	口
吧	口	巴
吨	口	屯
吩	分	口
吪	化	口
含	今	口
听	口	斤
吭	亢	口
吮	允	口
启	口	户
吰	厷	口
吱	口	支
吲	口	引
吳	口	大	𠃑
吴	口	天
吵	口	少
吶	內	口
吷	口	夬
吸	及	口
吹	口	欠
吺	口	殳
吻	勿	口
吼	口	孔
吽	口	牛
吾	五	口
吿	口	牛
呀	口	牙
呁	匀	口
呂	丿	口
呃	厄	口
呄	乃	古
呅	口	文
呆	口	木
呇	口	水
呈	口	王
呉	一	八	口	𠃑
告	口	𠂒
呋	口	夫
呌	口	斗
呍	云	口
呎	口	尺
呏	升	口
呐	内	口
呑	口	夭
呒	口	无
呓	口	艺
呔	口	太
呕	区	口
呖	历	口
呗	口	贝
员	口	贝
呙	内	口
呚	口	攵
呛	仓	口
呜	乌	口
呝	口	戹
呞	口	司
呟	口	玄
呠	口	本
呡	口	民
呢	口	尼
呣	口	母
呤	令	口
呥	冉	口
呦	口	幼
呧	口	氐
周	⺆	𠮷
呩	口	示
呪	兄	口
呫	占	口
呬	口	四
呭	世	口
呮	口	只
呯	口	平
呰	口	此
呱	口	瓜
呲	口	此
味	口	未
呴	口	句
呵	口	可
呶	口	奴
呷	口	甲
呸	丕	口
呹	口	失
呺	口	号
呻	口	申
呼	乎	口
命	亼	叩
呾	口	旦
呿	去	口
咀	且	口
咁	口	甘
咂	匝	口
咃	他	口
咄	出	口
咅	口	立
咆	包	口
咇	口	必
咈	口	弗
咉	口	央
咊	口	禾
咋	乍	口
和	口	禾
咍	口	台
咎	口	处
咏	口	永
咐	付	口
咑	口	打
咒	几	吅
咓	口	瓦
咔	卡	口
咕	口	古
咖	加	口
咗	口	左
咘	口	布
咙	口	龙
咚	冬	口
咛	口	宁
咜	口	它
咝	丝	口
咞	口	开
咟	口	百
咠	口	耳
咡	口	耳
咢	亏	吅
咣	光	口
咤	口	宅
咥	口	至
咦	口	夷
咧	列	口
咨	口	次
咩	口	羊
咪	口	米
咫	只	尺
咬	交	口
咭	口	吉
咮	口	朱
咯	口	各
咰	口	旬
咱	口	自
咲	关	口
咳	亥	口
咴	口	灰
咵	口	夸
咶	口	舌
咷	兆	口
咸	口	戌
咹	口	安
咺	亘	口
咻	休	口
咼	冎	口
咽	口	因
咾	口	老
咿	伊	口
哀	亠	口	𧘇
品	口	吅
哂	口	西
哃	口	同
哄	共	口
哅	匈	口
哆	口	多
哇	口	圭
哈	口	合
哉	口	𢦏
哊	口	有
哋	口	地
哌	口	𠂢
响	口	向
哎	口	艾
哏	口	艮
哐	匡	口
哑	亚	口
哒	口	达
哓	口	尧
哔	口	毕
哕	口	岁
哖	口	年
哗	华	口
哘	口	行
哙	会	口
哚	口	朵
哛	分	叱
哜	口	齐
哝	农	口
哞	口	牟
哟	口	约
哠	口	告
員	口	貝
哢	口	弄
哣	口	豆
哤	口	尨
哥	可
哦	口	我
哧	口	赤
哨	口	肖
哩	口	里
哪	口	那
哫	口	足
哬	何	口
哭	吅	犬
哮	口	孝
哯	口	見
哰	口	牢
哱	口	孛
哲	口	折
哳	口	折
哴	口	良
哵	别	口
哶	⺸	口
哷	口	寽
哸	口	妥
哹	口	孚
哺	口	甫
哻	口	旱
哼	亨	口
哽	口	更
哾	兑	口
哿	加	可
唀	口	秀
唁	口	言
唂	口	谷
唃	口	角
唄	口	貝
唅	口	含
唆	口	夋
唇	口	辰
唈	口	邑
唉	口	矣
唊	口	夾
唋	余	口
唌	口	延
唍	口	完
唎	利	口
唏	口	希
唐	口	广	肀
唑	口	坐
唒	口	酉
唓	口	車
唔	口	吾
唕	口	皁
唖	亜	口
唗	口	走
唘	又	口	石
唙	口	狄
唚	口	𠬶
唛	口	麦
唜	叱	末
唝	口	贡
唞	口	抖
唟	去	叱
唠	劳	口
唡	两	口
唢	口	𭕆
唣	口	皂
唤	口	奂
唥	冷	口
唦	口	沙
唧	即	口
唨	口	阻
唩	口	委
唪	口	奉
唫	口	金
唬	口	虎
唭	其	口
售	口	隹
唯	口	隹
唰	刷	口
唱	口	昌
唲	兒	口
唳	口	戾
唴	口	羌
唵	口	奄
唶	口	昔
唷	口	育
唸	口	念
唹	口	於
唺	典	口
唻	來	口
唼	口	妾
唽	口	析
唾	口	垂
唿	口	忽
啀	厓	口
啁	口	周
啂	乳	口
啃	口	肯
啄	口	豖
啅	卓	口
商	丷	亠	冏
啇	丷	亠	冂	古
啈	口	幸
啉	口	林
啊	口	阿
啋	口	采
啌	口	空
啍	享	口
啎	午	吾
問	口	門
啐	卒	口
啑	口	疌
啒	口	屈
啓	口	𢼄
啔	口	𫼉
啕	匋	口
啖	口	炎
啗	口	臽
啘	口	宛
啙	吅	此
啚	十	口	回
啛	口	妻
啜	叕	口
啝	口	和
啞	亞	口
啟	启	攵
啠	口	斦
啡	口	非
啢	兩	口
啣	卸	口
啤	卑	口
啥	口	舍
啦	口	拉
啧	口	责
啨	口	青
啩	卦	口
啪	口	拍
啫	口	者
啬	丷	回	土
啭	口	转
啮	口	齿
啯	口	国
啰	口	罗
啱	口	岩
啲	口	的
啳	卷	口
啴	单	口
啵	口	波
啶	口	定
啷	口	郎
啸	口	肃
啹	口	居
啺	口	昜
啻	口	帝
啼	口	帝
啽	口	弇
啾	口	秋
啿	口	甚
喀	口	客
喁	口	禺
喂	口	畏
喃	南	口
善	䒑	口	羊
喅	口	昱
喆	吉
喇	剌	口
喈	口	皆
喉	侯	口
喊	口	咸
喋	口	枼
喌	吅	州
喍	口	柴
喎	口	咼
喏	口	若
喐	口	郁
喑	口	音
喒	口	昝
喓	口	要
喔	口	屋
喕	口	面
喖	口	枯
喗	口	軍
喘	口	耑
喙	口	彖
喚	口	奐
喛	口	爰
喜	口	壴
喝	口	曷
喞	卽	口
喟	口	胃
喠	口	重
喡	口	韋
喢	口	臿
喣	呴	灬
喤	口	皇
喥	口	度
喦	品	山
喧	口	宣
喨	亮	口
喩	兪	口
喪	丿	乀	吅	土	𠄌
喫	口	契
喬	冋	呑
喭	口	彦
單	一	吅	甲
喯	口	奔
喰	口	食
喱	厘	口
喲	口	約
喳	口	查
喴	口	威
喵	口	苗
営	冖	吕	𭕄
喷	口	贲
喸	叱	甫
喹	口	奎
喺	係	口
喻	俞	口
喼	口	急
喽	口	娄
喾	冖	告	𭕄
喿	品	木
嗀	殳	𫯁
嗁	口	虒
嗂	䍃	口
嗃	口	高
嗄	口	夏
嗅	口	臭
嗆	倉	口
嗇	从	回	土
嗈	口	邕
嗉	口	素
嗊	口	貢
嗋	口	脅
嗌	口	益
嗍	口	朔
嗎	口	馬
嗏	口	茶
嗐	口	害
嗑	口	盍
嗒	口	荅
嗓	口	桑
嗔	口	真
嗕	口	辱
嗖	叟	口
嗗	口	骨
嗘	口	奚
嗙	口	旁
嗚	口	烏
嗛	兼	口
嗜	口	耆
嗝	口	鬲
嗞	兹	口
嗟	口	差
嗠	各	孚
嗡	口	翁
嗢	口	昷
嗣	口	司	𠕁
嗤	口	蚩
嗥	口	皋
嗦	口	索
嗧	侖	加
嗨	口	海
嗩	口	𧴪
嗪	口	秦
嗫	口	聂
嗬	口	荷
嗭	叱	直
嗮	口	晒
嗯	口	恩
嗰	個	口
嗱	口	拿
嗲	口	爹
嗳	口	爱
嗴	口	羗
嗵	口	通
嗶	口	畢
嗷	口	敖
嗸	口	敖
嗹	口	連
嗺	口	崔
嗻	口	庶
嗼	口	莫
嗽	口	欶
嗾	口	族
嗿	口	貪
嘀	口	啇
嘁	口	戚
嘂	丩	吕
嘃	口	庸
嘄	口	梟
嘅	口	既
嘆	口	夫	廿
嘇	參	口
嘈	口	曹
嘉	加	壴
嘊	口	崖
嘋	口	教
嘌	口	票
嘍	口	婁
嘎	口	戛
嘏	叚	古
嘐	口	翏
嘑	口	虖
嘒	口	彗
嘓	口	國
嘔	區	口
嘕	口	焉
嘖	口	責
嘗	旨	𫩠
嘘	口	虚
嘙	口	婆
嘚	口	得
嘛	口	麻
嘜	口	麥
嘝	口	斛
嘞	勒	口
嘟	口	都
嘠	口	戞
嘡	口	堂
嘢	口	野
嘣	口	崩
嘤	口	婴
嘥	口	徙
嘦	只	要
嘧	口	密
嘨	口	粛
嘩	口	華
嘪	口	買
嘫	口	然
嘬	口	最
嘭	口	彭
嘮	勞	口
嘯	口	肅
嘰	口	幾
嘱	口	属
嘲	口	朝
嘳	口	貴
嘴	口	觜
嘵	口	堯
嘶	口	斯
嘷	口	臯
嘸	口	無
嘹	口	尞
嘺	口	喬
嘻	口	喜
嘼	㽞	一	口
嘽	口	單
嘾	口	覃
嘿	口	黑
噀	口	巽
噁	口	惡
噂	口	尊
噃	口	番
噄	口	絜
噅	口	爲
噆	口	朁
噇	口	童
噈	口	就
噉	口	敢
噊	口	矞
噋	口	敦
噌	口	曾
噍	口	焦
噎	口	壹
噏	口	翕
噐	吅	工
噑	口	皐
噒	口	粦
噓	口	虛
噔	口	登
噕	口	爲
噖	口	琴
噗	口	菐
噘	厥	口
噙	口	禽
噚	口	尋
噛	口	歯
噜	口	鲁
噝	口	絲
噞	僉	口
噟	䧹	口
噠	口	達
噡	口	詹
噢	口	奥
噣	口	蜀
噤	口	禁
噥	口	農
噦	口	歲
噧	口	萬
器	吅	犬
噩	㗊	一	干
噪	口	喿
噫	口	意
噬	口	筮
噭	口	敫
噮	口	睘
噯	口	愛
噰	口	雍
噱	口	豦
噲	口	會
噳	口	虞
噴	口	賁
噵	口	道
噶	口	葛
噷	口	歆
噸	口	頓
噹	口	當
噺	口	新
噻	口	塞
噼	口	辟
噽	丕	喜
噾	口	窨
噿	口	翠
嚀	口	寧
嚁	口	翟
嚂	口	監
嚃	口	遝
嚄	口	蒦
嚅	口	需
嚆	口	蒿
嚇	口	赫
嚈	厭	口
嚉	口	對
嚊	口	鼻
嚋	口	壽
嚌	口	齊
嚍	口	盡
嚎	口	豪
嚏	口	疐
嚐	口	嘗
嚑	口	熏
嚒	口	麼
嚓	口	察
嚔	口	𤴡
嚕	口	魯
嚖	口	慧
嚗	口	暴
嚘	口	憂
嚙	口	齒
嚚	吅	臣
嚛	口	樂
嚜	口	墨
嚝	口	廣
嚞	吉	喆
嚟	口	黎
嚠	劉	口
嚡	口	鞋
嚢	一	中	八	冖	𠀎	𧘇
嚣	吅	页
嚤	口	摩
嚥	口	燕
嚦	口	歷
嚧	口	盧
嚨	口	龍
嚩	口	縛
嚪	口	閻
嚫	口	親
嚬	口	頻
嚭	否	喜
嚮	向	鄉
嚯	口	霍
嚰	口	磨
嚱	口	戲
嚲	享	單
嚳	告	𦥯
嚴	吅	𠪚
嚵	口	毚
嚶	口	嬰
嚷	口	襄
嚸	口	點
嚹	口	罅
嚺	㒸	口	罒	辶
嚻	吕	頁
嚼	口	爵
嚽	口	贅
嚾	口	雚
嚿	口	舊
囀	口	轉
囁	口	聶
囂	吅	頁
囃	口	雜
囄	口	離
囅	單	展
囆	口	蠆
囇	口	麗
囈	口	藝
囉	口	羅
囊	一	中	冖	吅	𠀎	𧘇
囋	口	贊
囌	口	蘇
囍	喜
囎	口	贈
囏	口	喜	夫	廿
囐	口	獻
囑	口	屬
囒	口	蘭
囓	口	齧
囔	口	囊
囕	口	覽
囖	口	籮
囗	囗
囘	冂	巳
囙	コ	囗
囚	人	囗
四	儿	囗
囜	厶	囗
囝	囗	子
回	口	囗
囟	㐅	丿	囗
因	囗	大
囡	囗	女
团	囗	才
団	囗	寸
囤	囗	屯
囥	亢	囗
囦	囗	水
囧	冂	四
囨	不	囗
囩	云	囗
囪	丶	丿	囗
囫	勿	囗
囬	④	囗
园	元	囗
囮	化	囗
囯	囗	王
困	囗	木
囱	丿	囗	夂
囲	井	囗
図	⺀	乂	囗
围	囗	韦
囵	仑	囗
囶	囗	𡉀
囷	囗	禾
囸	囗	正
囹	令	囗
固	古	囗
囻	囗	民
囼	台	囗
国	囗	玉
图	冬	囗
囿	囗	有
圀	八	囗	方
圁	囗	言
圂	囗	豕
圃	囗	甫
圄	吾	囗
圅	囗	龴	𢆉
圆	员	囗
圇	侖	囗
圈	卷	囗
圉	囗	幸
圊	囗	青
國	囗	或
圌	囗	耑
圍	囗	韋
圎	囗	貟
圏	囗	巻
圐	囗	𬙙
圑	囗	尃
園	囗	袁
圓	員	囗
圔	囗	盍
圕	囗	書
圖	啚	囗
圗	十	厶	囗	囬
團	囗	專
圙	八	囗	面
圚	囗	貴
圛	囗	睪
圜	囗	睘
圝	䜌	囗
圞	囗	欒
土	一	十
圠	乚	土
圡	丶	土
圢	丁	土
圣	又	土
圤	卜	土
圥	儿	土
圦	入	土
圧	厂	土
在	③	土
圩	于	土
圪	乞	土
圫	乇	土
圬	亏	土
圭	土
圮	土	己
圯	土	巳
地	也	土
圱	千	土
圲	千	土
圳	土	川
圴	勺	土
圵	上	土
圶	土	大
圷	下	土
圸	土	山
圹	土	广
场	土	𠃓
圻	土	斤
圼	土	日
圽	勿	土
圾	及	土
圿	介	土
址	土	止
坁	土	氏
坂	反	土
坃	元	土
坄	土	殳
坅	今	土
坆	土	攵
均	匀	土
坈	冗	土
坉	土	屯
坊	土	方
坋	分	土
坌	分	土
坍	丹	土
坎	土	欠
坏	不	土
坐	从	土
坑	亢	土
坒	土	比
坓	井	土
坔	土	水
坕	土	爪
坖	元	土
块	土	夬
坘	互	土
坙	一	土	巛
坚	〢	又	土
坛	云	土
坜	历	土
坝	土	贝
坞	乌	土
坟	土	文
坠	土	队
坡	土	皮
坢	半	土
坣	土	龸
坤	土	申
坥	且	土
坦	土	旦
坧	土	石
坨	土	它
坩	土	甘
坪	土	平
坫	占	土
坬	土	瓜
坭	土	尼
坮	台	土
坯	丕	土
坰	冋	土
坱	土	央
坲	土	弗
坳	土	幼
坴	土	圥
坵	丘	土
坶	土	母
坷	可	土
坸	句	土
坹	土	穴
坺	土	犮
坻	土	氐
坼	土	斥
坽	令	土
坾	土	宁
坿	付	土
垀	乎	土
垁	土	矢
垂	⑥	一	丿
垃	土	立
垄	土	龙
垅	土	龙
垆	卢	土
垇	凹	土
垈	代	土
垉	包	土
垊	土	民
型	刑	土
垌	同	土
垍	土	自
垎	各	土
垏	土	聿
垐	土	次
垑	土	多
垒	厽	土
垓	亥	土
垔	土	覀
垕	后	土
垖	土	𠂤
垗	兆	土
垘	伏	土
垙	光	土
垚	土	𪢴
垛	土	朵
垜	土	朶
垝	危	土
垞	土	宅
垟	土	羊
垠	土	艮
垡	伐	土
垢	后	土
垣	亘	土
垤	土	至
垥	合	土
垦	土	艮
垧	向	土
垨	土	守
垩	亚	土
垪	土	并
垫	土	执
垬	共	土
垭	亚	土
垮	土	夸
垯	土	达
垰	土	𠧗
垱	土	当
垲	土	岂
垳	土	行
垴	㐫	土
垵	土	安
垶	土	辛
垷	土	見
垸	土	完
垹	土	邦
垺	土	孚
垻	土	貝
垼	土	役
垽	土	沂
垾	土	旱
垿	土	序
埀	一	丨	丿	二	北
埁	土	岑
埂	土	更
埃	土	矣
埄	土	夆
埅	土	防
埆	土	角
埇	土	甬
埈	土	夋
埉	土	夾
埊	土	汖
埋	土	里
埌	土	良
埍	土	肙
城	土	成
埏	土	延
埐	土	𠬶
埑	土	折
埒	土	寽
埓	④	土	寸
埔	土	甫
埕	呈	土
埖	土	花
埗	土	步
埘	土	时
埙	员	土
埚	呙	土
埛	冏	土
埜	土	林
埝	土	念
埞	土	定
域	土	或
埠	土	阜
埡	亞	土
埢	卷	土
埣	卒	土
埤	卑	土
埥	土	青
埦	土	宛
埧	具	土
埨	侖	土
埩	争	土
埪	土	空
埫	土	尚
埬	土	東
埭	土	隶
埮	土	炎
埯	土	奄
埰	土	采
埱	叔	土
埲	土	奉
埳	土	臽
埴	土	直
埵	土	垂
埶	丸	坴
執	丸	幸
埸	土	易
培	咅	土
基	其	土
埻	享	土
埼	土	奇
埽	土	帚
埾	取	土
埿	土	泥
堀	土	屈
堁	土	果
堂	土	𫩠
堃	土	方
堄	兒	土
堅	土	臤
堆	土	隹
堇	口	廿	龶
堈	土	岡
堉	土	育
堊	亞	土
堋	土	朋
堌	固	土
堍	兔	土
堎	土	夌
堏	土	枋
堐	厓	土
堑	土	斩
堒	土	昆
堓	土	岸
堔	土	罙
堕	土	陏
堖	土	𡿺
堗	土	突
堘	土	龹
堙	土	垔
堚	土	軍
堛	土	畐
堜	土	柬
堝	咼	土
堞	土	枼
堟	土	彖
堠	侯	土
堡	保	土
堢	保	土
堣	土	禺
堤	土	是
堥	土	敄
堦	土	皆
堧	土	耎
堨	土	曷
堩	土	恆
堪	土	甚
堫	㚇	土
堬	俞	土
堭	土	皇
堮	咢	土
堯	兀	垚
堰	匽	土
報	幸	𠬝
堲	即	土
堳	土	眉
場	土	昜
堵	土	者
堶	土	左	月
堷	土	音
堸	土	風
堹	土	重
堺	土	界
堻	土	津
堼	土	封
堽	土	罡
堾	土	春
堿	咸	土
塀	土	屏
塁	丷	八	土	田
塂	土	巷
塃	土	荒
塄	土	𬙙
塅	土	段
塆	土	弯
塇	土	宣
塈	土	既
塉	土	脊
塊	土	鬼
塋	土	𤇾
塌	土	𦐇
塍	土	月	龹
塎	土	容
塏	土	豈
塐	土	素
塑	土	朔
塒	土	時
塓	冥	土
塔	土	荅
塕	土	翁
塖	乘	土
塗	土	涂
塘	唐	土
塙	土	高
塚	冢	土
塛	土	栗
塜	冡	土
塝	土	旁
塞	土	𡨄
塟	㘸	艹
塠	土	追
塡	土	眞
塢	土	烏
塣	土	浧
塤	員	土
塥	土	鬲
塦	土	陣
塧	土	益
塨	土	恭
塩	土	𬐚
塪	土	舀
填	土	真
塬	原	土
塭	土	昷
塮	土	射
塯	土	留
塰	土	海
塱	土	朗
塲	土	𬀷
塳	土	逢
塴	土	崩
塵	土	鹿
塶	土	鹿
塷	土	鹵
塸	區	土
塹	土	斬
塺	土	麻
塻	土	莫
塼	土	專
塽	土	爽
塾	土	孰
塿	土	婁
墀	土	犀
墁	土	曼
墂	土	票
境	土	竟
墄	土	戚
墅	土	野
墆	土	帶
墇	土	章
墈	勘	土
墉	土	庸
墊	土	執
墋	參	土
墌	土	庶
墍	土	旣
墎	土	郭
墏	土	將
墐	土	堇
墑	啇	土
墒	商	土
墓	土	莫
墔	土	崔
墕	土	焉
墖	土	畣
増	土	曽
墘	乾	土
墙	啬	土
墚	土	梁
墛	土	尉
墜	土	隊
墝	土	堯
增	土	曾
墟	土	虚
墠	單	土
墡	善	土
墢	土	發
墣	土	菐
墤	土	貴
墥	土	童
墦	土	番
墧	喬	土
墨	土	黑
墩	土	敦
墪	土	敦
墫	土	尊
墬	䧘	土
墭	土	盛
墮	土	隋
墯	土	惰
墰	土	覃
墱	土	登
墲	土	無
墳	土	賁
墴	土	黄
墵	土	雲
墶	土	達
墷	土	華
墸	土	著
墹	土	間
墺	土	奥
墻	嗇	土
墼	土	𣪠
墽	土	敫
墾	土	貇
墿	土	睪
壀	土	辟
壁	土	辟
壂	土	殿
壃	土	畺
壄	土	楙
壅	土	雍
壆	土	𦥯
壇	亶	土
壈	土	稟
壉	土	豦
壊	十	土	𭾱
壋	土	當
壌	㐮	土
壍	土	漸
壎	土	熏
壏	土	監
壐	土	爾
壑	㕡	土
壒	土	蓋
壓	厭	土
壔	土	壽
壕	土	豪
壖	土	需
壗	土	盡
壘	土	畾
壙	土	廣
壚	土	盧
壛	土	閻
壜	土	曇
壝	土	遺
壞	土	褱
壟	土	龍
壠	土	龍
壡	圣	睿
壢	土	歷
壣	土	聯
壤	土	襄
壥	㕓	土
壦	土	雚
壧	嚴	土
壨	土	𤳳
壩	土	霸
壪	土	彎
士	一	十
壬	丿	士
壭	丨	士	𠃌
壮	丬	士
壯	士	爿
声	士	𠃜
壱	冖	匕	士
売	士	冗
壳	冗	士
壴	十	豆
壵	士
壶	业	冖	士
壷	⑧	士
壸	亚	冖	士
壹	冖	士	豆
壺	⑥	一	冖	士
壻	士	胥
壼	亞	冖	士
壽	一	乛	吋	士	工
壾	壴	巨
壿	士	尊
夀	⑧	吋
夁	䍛	士
夂	夂
夃	乃	又
处	卜	夂
夅	㐄	夂
夆	丰	夂
备	夂	田
夈	夂	米
変	亦	夂
夊	夊
夋	八	厶	夂
夌	八	土	夂
复	夂	日	𠂉
夎	坐	夂
夏	夂	𦣻
夐	夂	目	𠂊	𠔿
夑	夂	火	言
夒	一	八	夂	巳	止	自
夓	八	夂	𦣻	𦥑
夔	丷	夒
夕	丶	𠂊
外	卜	夕
夗	㔾	夕
夘	卩	夕
夙	几	歹
多	夕
夛	夕	彐
夜	丶	亠	亻	夂
夝	夕	生
夞	叱	外
够	句	多
夠	句	多
夡	吉	多
夢	冖	夕	𦭝
夣	冖	夕	罒	𠫓
夤	夕	寅
夥	多	果
夦	多	甚
大	一	人
夨	大	𠃋
天	一	大
太	丶	大
夫	二	人
夬	大	𠃍
夭	丿	大
央	央
夯	力	大
夰	丨	丿	大
失	丿	夫
夲	十	大
夳	二	大
头	头
夵	大	小
夶	大
夷	大	弓
夸	亏	大
夹	丷	夫
夺	大	寸
夻	口	大
夼	大	川
夽	云	大
夾	从	大
夿	大	巴
奀	不	大
奁	区	大
奂	冂	大	𠂊
奃	大	氐
奄	大	电
奅	卯	大
奆	大	巨
奇	可	大
奈	大	示
奉	丨	二	𡗗
奊	圭	夨
奋	大	田
奌	占	大
奍	丨	丿	龹
奎	圭	大
奏	天	𡗗
奐	八	冂	大	𠂊
契	㓞	大
奒	亥	大
奓	多	大
奔	卉	大
奕	亦	大
奖	丬	夕	大
套	大	镸
奘	壯	大
奙	厶	奄
奚	爫	𡗞
奛	大	明
奜	大	非
奝	周	大
奞	大	隹
奟	大	朋
奠	大	酋
奡	夰	𦣻
奢	大	者
奣	天	明
奤	大	面
奥	丿	冂	大	米
奦	務	大
奧	丿	冂	大	釆
奨	大	将
奩	區	大
奪	奞	寸
奫	大	淵
奬	大	將
奭	大	皕
奮	奞	田
奯	大	歲
奰	大	𦋹
奱	䜌	大
奲	單	奢
女	女
奴	又	女
奵	丁	女
奶	乃	女
奷	千	女
奸	女	干
她	也	女
奺	久	女
奻	女
奼	乇	女
好	女	子
奾	女	山
奿	丸	女
妀	女	己
妁	勺	女
如	口	女
妃	女	己
妄	亡	女
妅	女	工
妆	丬	女
妇	女	彐
妈	女	马
妉	冘	女
妊	壬	女
妋	夫	女
妌	井	女
妍	女	开
妎	介	女
妏	女	文
妐	公	女
妑	女	巴
妒	女	户
妓	女	支
妔	亢	女
妕	中	女
妖	夭	女
妗	今	女
妘	云	女
妙	女	少
妚	不	女
妛	㞢	女
妜	夬	女
妝	女	爿
妞	丑	女
妟	女	日
妠	内	女
妡	女	斤
妢	分	女
妣	女	比
妤	予	女
妥	女	爫
妦	丰	女
妧	元	女
妨	女	方
妩	女	无
妪	区	女
妫	为	女
妬	女	石
妭	女	犮
妮	女	尼
妯	女	由
妰	乍	女
妱	召	女
妲	女	旦
妳	女	尔
妴	夗	女
妵	主	女
妶	女	玄
妷	失	女
妸	可	女
妹	女	未
妺	女	末
妻	コ	一	十	女
妼	女	必
妽	女	申
妾	女	立
妿	加	女
姀	女	禾
姁	句	女
姂	乏	女
姃	女	正
姄	女	民
姅	半	女
姆	女	母
姇	付	女
姈	令	女
姉	女	巿
姊	女	𠂔
始	台	女
姌	冉	女
姍	冊	女
姎	央	女
姏	女	甘
姐	且	女
姑	古	女
姒	以	女
姓	女	生
委	女	禾
姕	女	此
姖	女	巨
姗	册	女
姘	女	并
姙	任	女
姚	兆	女
姛	同	女
姜	女	𦍌
姝	女	朱
姞	吉	女
姟	亥	女
姠	向	女
姡	女	舌
姢	䏍	女
姣	交	女
姤	后	女
姥	女	老
姦	女	奻
姧	㚣	干
姨	夷	女
姩	女	年
姪	女	至
姫	女	臣
姬	女	𦣞
姭	劦	女
姮	亘	女
姯	光	女
姰	女	旬
姱	夸	女
姲	女	安
姳	名	女
姴	列	女
姵	女	𫥞
姶	合	女
姷	女	有
姸	女	幵
姹	女	宅
姺	先	女
姻	因	女
姼	多	女
姽	危	女
姾	全	女
姿	女	次
娀	女	戎
威	女	戌
娂	共	女
娃	圭	女
娄	女	米
娅	亚	女
娆	女	尧
娇	乔	女
娈	亦	女
娉	女	甹
娊	女	見
娋	女	肖
娌	女	里
娍	女	成
娎	女	折
娏	女	尨
娐	女	孚
娑	女	沙
娒	女	每
娓	女	尾
娔	克	女
娕	女	束
娖	女	足
娗	女	廷
娘	女	良
娙	女	巠
娚	女	男
娛	吳	女
娜	女	那
娝	否	女
娞	女	妥
娟	女	肙
娠	女	辰
娡	女	志
娢	含	女
娣	女	弟
娤	壯	女
娥	女	我
娦	兵	女
娧	兑	女
娨	女	旱
娩	免	女
娪	吾	女
娫	女	延
娬	女	武
娭	女	矣
娮	女	言
娯	呉	女
娰	似	女
娱	吴	女
娲	呙	女
娳	利	女
娴	女	闲
娵	取	女
娶	取	女
娷	垂	女
娸	其	女
娹	女	弦
娺	叕	女
娻	女	東
娼	女	昌
娽	女	录
娾	厓	女
娿	女	阿
婀	女	阿
婁	⑧	女
婂	女	帛
婃	女	宗
婄	咅	女
婅	匊	女
婆	女	波
婇	女	采
婈	夌	女
婉	女	宛
婊	女	表
婋	女	虎
婌	叔	女
婍	奇	女
婎	女	隹
婏	兔	女
婐	女	果
婑	女	委
婒	女	炎
婓	女	非
婔	女	非
婕	女	疌
婖	女	忝
婗	兒	女
婘	卷	女
婙	争	女
婚	女	昏
婛	京	女
婜	女	臤
婝	女	定
婞	女	幸
婟	固	女
婠	女	官
婡	來	女
婢	卑	女
婣	女	𣶒
婤	周	女
婥	卓	女
婦	女	帚
婧	女	青
婨	侖	女
婩	女	岸
婪	女	林
婫	女	昆
婬	㸒	女
婭	亞	女
婮	女	居
婯	女	丽
婰	典	女
婱	女	弦
婲	女	花
婳	女	画
婴	女	贝
婵	单	女
婶	女	审
婷	亭	女
婸	女	昜
婹	女	要
婺	女	敄
婻	南	女
婼	女	若
婽	叚	女
婾	兪	女
婿	女	胥
媀	女	禺
媁	女	韋
媂	女	帝
媃	女	柔
媄	女	美
媅	女	甚
媆	女	耎
媇	亲	女
媈	女	軍
媉	女	屋
媊	前	女
媋	女	春
媌	女	苗
媍	女	負
媎	女	者
媏	女	耑
媐	女	巸
媑	女	重
媒	女	某
媓	女	皇
媔	女	面
媕	女	弇
媖	女	英
媗	女	宣
媘	女	皆
媙	女	威
媚	女	眉
媛	女	爰
媜	女	貞
媝	女	秋
媞	女	是
媟	女	枼
媠	女	左	月
媡	女	柬
媢	冒	女
媣	女	染
媤	女	思
媥	女	扁
媦	女	胃
媧	咼	女
媨	女	酋
媩	女	胡
媪	女	昷
媫	⺊	コ	一	女	龰
媬	保	女
媭	女	须
媮	俞	女
媯	女	為
媰	女	芻
媱	䍃	女
媲	女	𣬉
媳	女	息
媴	女	袁
媵	女	月	龹
媶	女	茸
媷	女	辱
媸	女	蚩
媹	女	留
媺	女	𢼸
媻	女	般
媼	女	𥁕
媽	女	馬
媾	冓	女
媿	女	鬼
嫀	女	秦
嫁	女	家
嫂	叟	女
嫃	女	真
嫄	原	女
嫅	女	差
嫆	女	容
嫇	冥	女
嫈	女	𤇾
嫉	女	疾
嫊	女	素
嫋	女	弱
嫌	兼	女
嫍	女	舀
嫎	女	旁
嫏	女	郎
嫐	女	男
嫑	不	要
嫒	女	爱
嫓	女	比	𠂊	𠔿
嫔	女	宾
嫕	女	悘
嫖	女	票
嫗	區	女
嫘	女	累
嫙	女	旋
嫚	女	曼
嫛	女	殹
嫜	女	章
嫝	女	康
嫞	女	庸
嫟	匿	女
嫠	女	𠩺
嫡	啇	女
嫢	女	規
嫣	女	焉
嫤	堇	女
嫥	女	專
嫦	女	常
嫧	女	責
嫨	口	夫	女	廿
嫩	女	敕
嫪	女	翏
嫫	女	莫
嫬	女	庶
嫭	女	虖
嫮	女	雩
嫯	女	敖
嫰	女	欶
嫱	啬	女
嫲	女	麻
嫳	女	敝
嫴	女	辜
嫵	女	無
嫶	女	焦
嫷	女	隋
嫸	善	女
嫹	女	黄
嫺	女	閒
嫻	女	閑
嫼	女	黑
嫽	女	尞
嫾	女	粦
嫿	女	畫
嬀	女	爲
嬁	女	登
嬂	女	戠
嬃	女	須
嬄	壹	女
嬅	女	華
嬆	女	翕
嬇	女	貴
嬈	堯	女
嬉	喜	女
嬊	北	口	女	廿
嬋	單	女
嬌	喬	女
嬍	女	𢽠
嬎	免	女	生
嬏	女	番
嬐	僉	女
嬑	女	意
嬒	女	會
嬓	女	敫
嬔	兔	女	生
嬕	女	睪
嬖	女	辟
嬗	亶	女
嬘	女	遂
嬙	嗇	女
嬚	女	廉
嬛	女	睘
嬜	女	歆
嬝	女	裊
嬞	女	董
嬟	女	義
嬠	喿	女
嬡	女	愛
嬢	㐮	女
嬣	女	寧
嬤	女	麼
嬥	女	翟
嬦	壽	女
嬧	女	盡
嬨	女	慈
嬩	女	與
嬪	女	賓
嬫	女	榮
嬬	女	需
嬭	女	爾
嬮	厭	女
嬯	女	臺
嬰	女	賏
嬱	女	漸
嬲	女	男
嬳	女	蒦
嬴	凡	吂	女	月
嬵	女	綿
嬶	女	鼻
嬷	女	麽
嬸	女	審
嬹	女	興
嬺	女	慝
嬻	女	賣
嬼	劉	女
嬽	女	𡚇
嬾	女	頼
嬿	女	燕
孀	女	霜
孁	女	霝
孂	女	簋
孃	女	襄
孄	女	闌
孅	女	韱
孆	女	嬰
孇	女	雙
孈	女	巂
孉	女	雚
孊	女	靡
孋	女	麗
孌	䜌	女
孍	嚴	女
孎	女	屬
孏	女	蘭
子	子
孑	孑
孒	孒
孓	孓
孔	乚	子
孕	乃	子
孖	子
字	子	宀
存	③	子
孙	子	小
孚	子	爫
孛	冖	十	子
孜	子	攵
孝	子	耂
孞	子	心
孟	子	皿
孠	司	子
孡	台	子
孢	包	子
季	子	禾
孤	子	瓜
孥	奴	子
学	冖	子	𭕄
孧	子	幼
孨	子	孖
孩	亥	子
孪	亦	子
孫	子	系
孬	不	好
孭	子	貝
孮	子	宗
孯	子	臤
孰	丸	享
孱	孨	尸
孲	亞	子
孳	兹	子
孴	孨	日
孵	卵	孚
孶	子	茲
孷	子	𠩺
學	子	𦥯
孹	子	辟
孺	子	需
孻	子	盡
孼	子	辥
孽	子	薛
孾	嬰	子
孿	䜌	子
宀	宀
宁	丁	宀
宂	几	宀
它	匕	宀
宄	九	宀
宅	乇	宀
宆	宀	弓
宇	于	宀
守	宀	寸
安	女	宀
宊	宀	犬
宋	宀	木
完	元	宀
宍	六	宀
宎	夭	宀
宏	厷	宀
宐	宀	彑
宑	井	宀
宒	宀	毛
宓	宀	必
宔	主	宀
宕	宀	石
宖	宀	弘
宗	宀	示
官	㠯	宀
宙	宀	由
定	宀	𤴓
宛	夗	宀
宜	且	宀
宝	宀	玉
实	头	宀
実	宀	𡗗
宠	宀	龙
审	宀	申
客	各	宀
宣	亘	宀
室	宀	至
宥	宀	有
宦	宀	臣
宧	宀	𦣞
宨	兆	宀
宩	宀	米
宪	先	宀
宫	吕	宀
宬	宀	成
宭	君	宀
宮	呂	宀
宯	孝	宀
宰	宀	辛
宱	作	宀
宲	呆	宀
害	口	𫲸
宴	妟	宀
宵	宀	肖
家	宀	豕
宷	宀	釆
宸	宀	辰
容	宀	谷
宺	宀	𠯚
宻	丷	又	宀	山
宼	元	女	宀
宽	宀	苋
宾	兵	宀
宿	佰	宀
寀	宀	采
寁	宀	疌
寂	叔	宀
寃	兔	宀
寄	奇	宀
寅	一	八	宀	由
密	宓	山
寇	元	宀	攴
寈	宀	青
寉	宀	隹
寊	宀	貞
寋	㔾	𡨄
富	宀	畐
寍	宀	𬐘
寎	丙	宀	爿
寏	奐	宀
寐	宀	未	爿
寑	侵	宀
寒	⺀	𡨄
寓	宀	禺
寔	宀	是
寕	㝉	丁	丿	罒
寖	宀	浸
寗	冉	宓
寘	宀	真
寙	㼌	宀
寚	宀	王	缶
寛	宀	莧
寜	亅	寍
寝	丬	宀	𠬶
寞	宀	莫
察	宀	祭
寠	婁	宀
寡	丆	且	分	宀
寢	宀	𭷆
寣	宀	𪺞
寤	宀	𤕻
寥	宀	翏
實	宀	貫
寧	丁	寍
寨	木	𡨄
審	宀	番
寪	宀	爲
寫	宀	舄
寬	宀	萈
寭	宀	惠
寮	宀	尞
寯	宀	雋
寰	宀	睘
寱	宀	爿	臬
寲	宀	疑
寳	宀	珎	貝
寴	宀	親
寵	宀	龍
寶	貝	𡩧
寷	宀	豐
寸	寸
对	又	寸
寺	土	寸
寻	寸	彐
导	寸	巳
寽	寸	爫
対	寸	文
寿	丰	寸
尀	叵	寸
封	圭	寸
専	寸	𤰔
尃	寸	甫
射	寸	身
尅	克	寸
将	丬	𪧷
將	冫	寸	爿	𠂊
專	⑧	寸
尉	寸	𫵖
尊	寸	酋
尋	口	寸	工	彐
尌	壴	寸
對	业	寸	𦍌
導	寸	道
小	小
尐	乀	小
少	丿	小
尒	人	小
尓	小	𠂉
尔	小	𠂊
尕	乃	小
尖	大	小
尗	上	小
尘	土	小
尙	冋	小
尚	⺌	冋
尛	小
尜	夵	小
尝	云	龸
尞	小	昚
尟	少	是
尠	少	甚
尡	光	昆
尢	尢
尣	儿	八
尤	丶	尢
尥	勺	尢
尦	勺	尣
尧	兀	𭠍
尨	尤	彡
尩	尣	王
尪	尢	王
尫	兀	王
尬	介	尢
尭	兀	卉
尮	尢	朶
尯	危	尢
尰	尢	重
就	京	尤
尲	兼	尢
尳	尢	骨
尴	尢	监
尵	尢	貴
尶	兀	監
尷	尢	監
尸	尸
尹	コ	一	丿
尺	尺
尻	九	尸
尼	匕	尸
尽	⺀	尺
尾	尸	毛
尿	尸	水
局	口	尸	𠃌
屁	尸	比
层	云	尸
屃	尸	贝
屄	尸	穴
居	古	尸
屆	凷	尸
屇	尸	田
屈	出	尸
屉	世	尸
届	尸	由
屋	尸	至
屌	吊	尸
屍	尸	死
屎	尸	米
屏	尸	并
屐	尸	𫹍
屑	尸	肖
屒	尸	辰
屓	尸	貝
屔	丘	尼
展	丿	乀	尸	龷	𠄌
屖	尸	辛
屗	寸	尾
屘	子	尾
屙	尸	阿
屚	尸	雨
屛	尸	幷
屜	世	尸	彳
屝	尸	非
属	尸	禹
屟	尸	枼
屠	尸	者
屡	娄	尸
屢	婁	尸
屣	尸	徙
層	尸	曾
履	尸	復
屦	娄	尸	彳
屧	尸	彳	枼
屨	婁	尸	彳
屩	尸	𢕪
屪	寮	尸
屫	喬	尸	爿
屬	丨	丷	八	尸	蜀
屭	尸	贔
屮	丨	凵
屯	丿	𡳾
屰	䒑	屮
山	山
屲	丿	山
屳	入	山
屴	力	山
屵	厂	山
屶	刀	山
屷	乃	山
屸	山	工
屹	乞	山
屺	山	己
屻	刃	山
屼	兀	山
屽	山	干
屾	山
屿	与	山
岀	山
岁	夕	山
岂	山	己
岃	刃	山
岄	山	月
岅	反	山
岆	夭	山
岇	卬	山
岈	山	牙
岉	勿	山
岊	山	巴
岋	及	山
岌	及	山
岍	山	开
岎	分	山
岏	元	山
岐	山	支
岑	今	山
岒	今	山
岓	山	斤
岔	分	山
岕	介	山
岖	区	山
岗	冈	山
岘	山	见
岙	夭	山
岚	山	风
岛	④	山
岜	山	巴
岝	乍	山
岞	乍	山
岟	央	山
岠	山	巨
岡	䒑	冂	山
岢	可	山
岣	句	山
岤	山	穴
岥	山	皮
岦	山	立
岧	召	山
岨	且	山
岩	山	石
岪	山	弗
岫	山	由
岬	山	甲
岭	令	山
岮	它	山
岯	丕	山
岰	山	幼
岱	代	山
岲	兄	山
岳	丘	山
岴	丘	山
岵	古	山
岶	山	白
岷	山	民
岸	厈	山
岹	召	山
岺	令	山
岻	山	氐
岼	山	平
岽	东	山
岾	占	山
岿	山	归
峀	山	由
峁	卯	山
峂	冬	山
峃	冖	山	𭕄
峄	山	𠬤
峅	山	弁
峆	合	山
峇	合	山
峈	各	山
峉	各	山
峊	山	𠂤
峋	山	旬
峌	山	至
峍	山	聿
峎	山	艮
峏	山	而
峐	亥	山
峑	全	山
峒	同	山
峓	夷	山
峔	山	老
峕	山	𣅀
峖	安	山
峗	危	山
峘	亘	山
峙	寺	山
峚	圶	山
峛	列	山
峜	企	山
峝	同	山
峞	危	山
峟	山	有
峠	山	𠧗
峡	夹	山
峢	列	山
峣	尧	山
峤	乔	山
峥	争	山
峦	亦	山
峧	交	山
峨	山	我
峩	山	我
峪	山	谷
峫	山	邪
峬	山	甫
峭	山	肖
峮	君	山
峯	夆	山
峰	夆	山
峱	丑	山	犭
峲	利	山
峳	山	攸
峴	山	見
峵	宏	山
島	⑦	山
峷	山	辛
峸	山	成
峹	余	山
峺	山	更
峻	夋	山
峼	告	山
峽	夾	山
峾	山	沂
峿	吾	山
崀	山	良
崁	坎	山
崂	劳	山
崃	山	来
崄	佥	山
崅	山	角
崆	山	空
崇	宗	山
崈	宗	山
崉	山	沓
崊	山	林
崋	⑦	山
崌	居	山
崍	來	山
崎	奇	山
崏	山	昏
崐	山	昆
崑	山	昆
崒	卒	山
崓	固	山
崔	山	隹
崕	厓	山
崖	厓	山
崗	山	岡
崘	侖	山
崙	侖	山
崚	夌	山
崛	屈	山
崜	垂	山
崝	山	青
崞	享	山
崟	山	金
崠	山	東
崡	函	山
崢	山	爭
崣	委	山
崤	山	肴
崥	卑	山
崦	奄	山
崧	山	松
崨	山	疌
崩	山	朋
崪	卒	山
崫	屈	山
崬	山	東
崭	山	斩
崮	固	山
崯	山	金
崰	山	甾
崱	則	山
崲	山	皇
崳	俞	山
崴	威	山
崵	山	昜
崶	封	山
崷	山	酋
崸	山	頁
崹	山	帝
崺	山	施
崻	山	待
崼	山	是
崽	山	思
崾	山	要
崿	咢	山
嵀	山	柱
嵁	山	甚
嵂	山	律
嵃	山	彦
嵄	山	美
嵅	咸	山
嵆	山	𮂱
嵇	尤	山	禾
嵈	山	爰
嵉	亭	山
嵊	乘	山
嵋	山	眉
嵌	山	𣢟
嵍	山	敄
嵎	山	禺
嵏	㚇	山
嵐	山	風
嵑	山	曷
嵒	品	山
嵓	品	山
嵔	山	畏
嵕	㚇	山
嵖	山	查
嵗	山	戌	𣥂
嵘	山	荣
嵙	山	科
嵚	山	钦
嵛	俞	山
嵜	山	竒
嵝	娄	山
嵞	余	屾
嵟	屵	隹
嵠	奚	山
嵡	山	翁
嵢	倉	山
嵣	唐	山
嵤	山	𤇾
嵥	山	桀
嵦	山	豈
嵧	山	留
嵨	山	烏
嵩	山	高
嵪	山	高
嵫	兹	山
嵬	山	鬼
嵭	山	旁
嵮	山	真
嵯	山	差
嵰	兼	山
嵱	容	山
嵲	山	臬
嵳	山	差
嵴	山	脊
嵵	山	時
嵶	山	弱
嵷	山	從
嵸	山	從
嵹	山	强
嵺	山	翏
嵻	山	康
嵼	山	産
嵽	山	帶
嵾	參	山
嵿	山	頂
嶀	山	雩
嶁	婁	山
嶂	山	章
嶃	山	斬
嶄	山	斬
嶅	山	敖
嶆	山	曹
嶇	區	山
嶈	將	山
嶉	唯	山
嶊	山	推
嶋	山	鳥
嶌	山	鳥
嶍	山	習
嶎	尉	山
嶏	屵	配
嶐	山	隆
嶑	山	象
嶒	山	曾
嶓	山	番
嶔	山	欽
嶕	山	焦
嶖	山	翕
嶗	勞	山
嶘	山	棧
嶙	山	粦
嶚	尞	山
嶛	尞	山
嶜	山	朁
嶝	山	登
嶞	山	隋
嶟	尊	山
嶠	喬	山
嶡	厥	山
嶢	堯	山
嶣	山	焦
嶤	堯	山
嶥	厥	山
嶦	山	詹
嶧	山	睪
嶨	山	𦥯
嶩	山	農
嶪	山	業
嶫	山	業
嶬	山	義
嶭	山	辛	𠂤
嶮	僉	山
嶯	山	戢
嶰	山	解
嶱	山	葛
嶲	山	雋
嶳	山	豕	𪢴
嶴	奥	山
嶵	山	罪
嶶	山	微
嶷	山	疑
嶸	山	榮
嶹	壽	山
嶺	山	領
嶻	山	截
嶼	山	與
嶽	山	獄
嶾	㥯	山
嶿	山	需
巀	山	𢧵
巁	厲	山
巂	冏	崔
巃	山	龍
巄	山	龍
巅	山	颠
巆	山	營
巇	山	戲
巈	山	鞠
巉	山	毚
巊	嬰	山
巋	山	歸
巌	厳	山
巍	山	魏
巎	夒	山
巏	山	雚
巐	山	髜
巑	山	贊
巒	䜌	山
巓	山	顚
巔	山	顛
巕	㜸	山
巖	嚴	山
巗	嚴	山
巘	山	獻
巙	夔	山
巚	山	獻
巛	𡿨
巜	𡿨
川	川
州	州
巟	亡	𫶧
巠	一	巛	工
巡	巛	辶
巢	巛	果
巣	果	𭕄
巤	⑦	巛	龱
工	工
左	工	𠂇
巧	丂	工
巨	巨
巩	凡	工
巪	巨	𠃍
巫	从	工
巬	几	夫	工
巭	功	夫
差	工	羊
巯	㐬	𢀖
巰	㐬	巠
己	己
已	已
巳	巳
巴	巴
巵	巴	𠂋
巶	召	巳
巷	共	巳
巸	巳	𦣞
巹	丞	己
巺	一	八	巳
巻	己	龹
巼	叱	巴
巽	共	巳
巾	巾
巿	一	巾
帀	一	巾
币	丿	巾
市	亠	巾
布	巾	𠂇
帄	丁	巾
帅	丨	丿	巾
帆	凡	巾
帇	コ	一	巾
师	丨	丿	帀
帉	分	巾
帊	巴	巾
帋	巾	氏
希	㐅	布
帍	巾	户
帎	冘	巾
帏	巾	韦
帐	巾	长
帑	奴	巾
帒	代	巾
帓	巾	末
帔	巾	皮
帕	巾	白
帖	占	巾
帗	巾	犮
帘	巾	穴
帙	失	巾
帚	冖	巾	彐
帛	巾	白
帜	只	巾
帝	丷	亠	冖	巾
帞	巾	百
帟	亦	巾
帠	巾	臼
帡	巾	并
帢	合	巾
帣	巾	龹
帤	如	巾
帥	巾	𠂤
带	冖	卅	巾
帧	巾	贞
帨	兑	巾
帩	巾	肖
帪	巾	辰
師	帀	𠂤
帬	君	巾
席	巾	广	廿
帮	巾	邦
帯	丗	冖	巾
帰	②	帚
帱	寿	巾
帲	巾	幷
帳	巾	長
帴	巾	戔
帵	宛	巾
帶	⑤	冖	巾
帷	巾	隹
常	巾	𫩠
帹	妾	巾
帺	其	巾
帻	巾	责
帼	国	巾
帽	冒	巾
帾	巾	者
帿	侯	巾
幀	巾	貞
幁	巾	頁
幂	巾	𠖇
幃	巾	韋
幄	屋	巾
幅	巾	畐
幆	巾	曷
幇	封	巾
幈	屏	巾
幉	巾	枼
幊	巾	貢
幋	巾	般
幌	巾	晃
幍	巾	舀
幎	冥	巾
幏	家	巾
幐	帣	月
幑	山	帀	彳	攵
幒	巾	悤
幓	參	巾
幔	巾	曼
幕	巾	莫
幖	巾	票
幗	國	巾
幘	巾	責
幙	巾	莫
幚	帛	邦
幛	巾	章
幜	巾	景
幝	單	巾
幞	巾	菐
幟	巾	戠
幠	巾	無
幡	巾	番
幢	巾	童
幣	巾	敝
幤	巾	敞
幥	巾	掌
幦	巾	辟
幧	喿	巾
幨	巾	詹
幩	巾	賁
幪	巾	蒙
幫	封	帛
幬	壽	巾
幭	巾	蔑
幮	巾	廚
幯	巾	節
幰	巾	憲
幱	巾	闌
干	干
平	丷	干
年	年
幵	干
并	丷	开
幷	丿	干
幸	土	𢆉
幹	𠦝	𫢉
幺	②	丶
幻	幺	𠃌
幼	力	幺
幽	山	𢆶
幾	人	戈	𢆶
广	广
庀	匕	广
庁	丁	广
庂	人	广
広	厶	广
庄	土	广
庅	么	广
庆	大	广
庇	广	比
庈	今	广
庉	屯	广
床	广	木
庋	广	支
庌	广	牙
庍	广	斤
庎	介	广
序	予	广
庐	广	户
庑	广	无
庒	圡	广
库	广	车
应	一	广	𭕄
底	广	氐
庖	包	广
店	占	广
庘	广	甲
庙	广	由
庚	コ	一	人	广
庛	广	此
府	付	广
庝	冬	广
庞	广	龙
废	发	广
庠	广	羊
庡	广	衣
庢	广	至
庣	兆	广
庤	寺	广
庥	休	广
度	又	广	廿
座	坐	广
庨	孝	广
庩	余	广
庪	广	技
庫	广	車
庬	尨	广
庭	广	廷
庮	广	酉
庯	广	甫
庰	并	广
庱	夌	广
庲	來	广
庳	卑	广
庴	广	昔
庵	奄	广
庶	广	廿	灬
康	广	隶
庸	广	𬎾
庹	尺	广	廿
庺	广	枀
庻	从	广	廿
庼	广	顷
庽	广	禺
庾	广	臾
庿	广	苗
廀	叜	广
廁	則	广
廂	广	相
廃	广	発
廄	⑤	广	殳
廅	广	盍
廆	广	鬼
廇	广	留
廈	夏	广
廉	兼	广
廊	广	郎
廋	叟	广
廌	②	コ	丨	广	灬
廍	广	部
廎	广	頃
廏	广	𣪘
廐	广	既
廑	堇	广
廒	广	敖
廓	广	郭
廔	婁	广
廕	广	陰
廖	广	翏
廗	帶	广
廘	广	鹿
廙	广	異
廚	尌	广
廛	儿	土	广	里
廜	屠	广
廝	广	斯
廞	广	欽
廟	广	朝
廠	广	敞
廡	广	無
廢	广	發
廣	广	黄
廤	叱	庫
廥	广	會
廦	广	辟
廧	嗇	广
廨	广	解
廩	广	稟
廪	广	禀
廫	广	膠
廬	广	盧
廭	广	積
廮	嬰	广
廯	广	鮮
廰	广	聴
廱	广	雝
廲	广	麗
廳	广	聽
廴	廴
廵	巛	廴
延	③	丿	廴
廷	壬	廴
廸	廴	由
廹	廴	白
建	廴	聿
廻	回	廴
廼	廴	西
廽	囬	廴
廾	一	丨	丿
廿	廿
开	一	廾
弁	厶	廾
异	巳	廾
弃	廾	𠫓
弄	廾	王
弅	分	廾
弆	去	廾
弇	合	廾
弈	亦	廾
弉	壯	廾
弊	廾	敝
弋	丶	𫠠
弌	一	弋
弍	二	弋
弎	三	弋
式	工	弋
弐	一	弍
弑	式	杀
弒	式	𣏂
弓	弓
弔	丨	弓
引	丨	弓
弖	一	弓
弗	丨	丿	弓
弘	厶	弓
弙	于	弓
弚	丷	弔
弛	也	弓
弜	弓
弝	巴	弓
弞	弓	欠
弟	丷	𢎨
张	弓	长
弡	巨	弓
弢	弓	𠬢
弣	付	弓
弤	弓	氐
弥	尔	弓
弦	弓	玄
弧	弓	瓜
弨	召	弓
弩	奴	弓
弪	弓	𢀖
弫	弓	臣
弬	弓	𦣝
弭	弓	耳
弮	弓	龹
弯	亦	弓
弰	弓	肖
弱	冫	弓
弲	弓	肙
弳	巠	弓
弴	享	弓
張	弓	長
弶	京	弓
強	弓	𧈧
弸	弓	朋
弹	单	弓
强	弓	虽
弻	㐁	弓
弼	弓	百
弽	弓	枼
弾	単	弓
弿	弓	𡨄
彀	一	冖	士	弓	殳
彁	哥	弓
彂	业	矤
彃	弓	畢
彄	區	弓
彅	剪	弓
彆	弓	敝
彇	弓	肅
彈	單	弓
彉	弓	黄
彊	弓	畺
彋	弓	睘
彌	弓	爾
彍	廣	弓
彎	䜌	弓
彏	弓	矍
彐	彐
彑	彑
归	丨	丿	彐
当	⺌	彐
彔	彑	氺
录	彐	氺
彖	彑	𧰨
彗	丰	彐
彘	匕	彑	矢
彙	冖	彑	果
彚	冖	彐	果
彛	彐	𪪷
彜	彑	𪪷
彝	廾	彑	米	糸
彞	廾	彐	米	糸
彟	寻	蒦
彠	尋	蒦
彡	彡
形	开	彡
彣	彡	文
彤	丹	彡
彥	厂	彡	文
彦	产	彡
彧	丿	或
彨	丽	彡
彩	彡	采
彪	彡	虎
彫	周	彡
彬	彡	林
彭	壴	彡
彮	容	彡
彯	彡	票
彰	彡	章
影	彡	景
彲	彡	麗
彳	彳
彴	勺	彳
彵	也	彳
彶	及	彳
彷	彳	方
彸	公	彳
役	彳	殳
彺	彳	王
彻	切	彳
彼	彳	皮
彽	彳	氐
彾	令	彳
彿	弗	彳
往	主	彳
征	彳	正
徂	且	彳
徃	彳	生
径	彳	𢀖
待	寺	彳
徆	彳	西
徇	彳	旬
很	彳	艮
徉	彳	羊
徊	回	彳
律	彳	聿
後	夂	幺	彳
徍	圭	彳
徎	呈	彳
徏	彳	步
徐	余	彳
徑	巠	彳
徒	彳	走
従	丷	彳	𤴓
徔	彳	芝
徕	彳	来
徖	宗	彳
得	㝵	彳
徘	彳	非
徙	彳	歨
徚	彳	柬
徛	奇	彳
徜	尚	彳
徝	彳	直
從	从	彳	龰
徟	周	彳
徠	來	彳
御	卸	彳
徢	彳	疌
徣	彳	昔
徤	建	彳
徥	彳	是
徦	叚	彳
徧	彳	扁
徨	彳	皇
復	复	彳
循	彳	盾
徫	彳	韋
徬	彳	旁
徭	䍃	彳
微	彳	𢼸
徯	奚	彳
徰	彳	正
徱	彳	票
徲	彳	犀
徳	十	彳	心	罒
徴	㞷	彳	攵
徵	彳	𢽠
徶	彳	敝
德	彳	𢛳
徸	彳	童
徹	彳	攵	育
徺	堯	彳
徻	彳	會
徼	彳	敫
徽	彳	𢾰
徾	彳	攵	訔
徿	彳	龍
忀	彳	襄
忁	大	彳	氺	𣅽
忂	彳	瞿
心	心
忄	忄
必	丿	心
忆	乙	忄
忇	力	忄
忈	二	心
忉	刀	忄
忊	丁	忄
忋	己	忄
忌	己	心
忍	刃	心
忎	千	心
忏	千	忄
忐	上	心
忑	下	心
忒	弋	心
忓	干	忄
忔	乞	忄
忕	大	忄
忖	寸	忄
志	士	心
忘	亡	心
忙	亡	忄
忚	也	忄
忛	凡	忄
応	广	心
忝	㣺	天
忞	心	文
忟	忄	文
忠	中	心
忡	中	忄
忢	五	心
忣	及	忄
忤	午	忄
忥	心	气
忦	介	忄
忧	尤	忄
忨	元	忄
忩	公	心
忪	公	忄
快	夬	忄
忬	予	忄
忭	卞	忄
忮	忄	支
忯	忄	氏
忰	卆	忄
忱	冘	忄
忲	太	忄
忳	屯	忄
忴	今	忄
念	今	心
忶	云	忄
忷	凶	忄
忸	丑	忄
忹	忄	王
忺	忄	欠
忻	忄	斤
忼	亢	忄
忽	勿	心
忾	忄	气
忿	分	心
怀	不	忄
态	太	心
怂	从	心
怃	忄	无
怄	区	忄
怅	忄	长
怆	仓	忄
怇	巨	忄
怈	世	忄
怉	包	忄
怊	召	忄
怋	忄	民
怌	丕	忄
怍	乍	忄
怎	乍	心
怏	央	忄
怐	句	忄
怑	半	忄
怒	奴	心
怓	奴	忄
怔	忄	正
怕	忄	白
怖	布	忄
怗	占	忄
怘	古	心
怙	古	忄
怚	且	忄
怛	忄	旦
怜	令	忄
思	心	田
怞	忄	由
怟	忄	氐
怠	台	心
怡	台	忄
怢	失	忄
怣	失	心
怤	付	心
急	刍	心
怦	平	忄
性	忄	生
怨	夗	心
怩	尼	忄
怪	圣	忄
怫	弗	忄
怬	四	忄
怭	忄	必
怮	幼	忄
怯	去	忄
怰	忄	玄
怱	匆	心
怲	丙	忄
怳	兄	忄
怴	忄	戉
怵	忄	术
怶	忄	皮
怷	心	朮
怸	心	术
怹	他	心
怺	忄	永
总	心	𠮦
怼	对	心
怽	忄	未
怾	只	忄
怿	忄	𠬤
恀	多	忄
恁	任	心
恂	忄	旬
恃	寺	忄
恄	吉	忄
恅	忄	老
恆	亙	忄
恇	匡	忄
恈	忄	牟
恉	忄	旨
恊	劦	忄
恋	亦	心
恌	兆	忄
恍	光	忄
恎	忄	至
恏	好	心
恐	巩	心
恑	危	忄
恒	亘	忄
恓	忄	西
恔	交	忄
恕	如	心
恖	囟	心
恗	夸	忄
恘	休	忄
恙	心	𦍌
恚	圭	心
恛	回	忄
恜	式	忄
恝	㓞	心
恞	夷	忄
恟	匈	忄
恠	在	忄
恡	忄	𠫤
恢	忄	灰
恣	心	次
恤	忄	血
恥	心	耳
恦	向	忄
恧	心	而
恨	忄	艮
恩	因	心
恪	各	忄
恫	同	忄
恬	忄	舌
恭	㣺	共
恮	全	忄
息	心	自
恰	合	忄
恱	兊	忄
恲	并	忄
恳	心	艮
恴	心	𣅀
恵	心	𤰔
恶	亚	心
恷	休	心
恸	动	忄
恹	厌	忄
恺	岂	忄
恻	则	忄
恼	㐫	忄
恽	军	忄
恾	忄	芒
恿	心	甬
悀	忄	甬
悁	忄	肙
悂	坒	忄
悃	困	忄
悄	忄	肖
悅	兌	忄
悆	余	心
悇	余	忄
悈	忄	戒
悉	心	釆
悊	心	折
悋	吝	忄
悌	弟	忄
悍	忄	旱
悎	告	忄
悏	夾	忄
悐	心	狄
悑	忄	甫
悒	忄	邑
悓	忄	見
悔	忄	每
悕	希	忄
悖	孛	忄
悗	免	忄
悘	医	心
悙	亨	忄
悚	忄	束
悛	夋	忄
悜	呈	忄
悝	忄	里
悞	吳	忄
悟	吾	忄
悠	心	攸
悡	利	心
悢	忄	良
患	串	心
悤	囱	心
悥	心	言
悦	兑	忄
悧	利	忄
您	你	心
悩	凶	忄	𭕄
悪	亜	心
悫	壳	心
悬	县	心
悭	坚	忄
悮	吴	忄
悯	忄	闵
悰	宗	忄
悱	忄	非
悲	心	非
悳	心	直
悴	卒	忄
悵	忄	長
悶	心	門
悷	忄	戾
悸	季	忄
悹	官	心
悺	官	忄
悻	幸	忄
悼	卓	忄
悽	妻	忄
悾	忄	空
悿	忄	忝
惀	侖	忄
惁	心	析
惂	忄	臽
惃	忄	昆
惄	叔	心
情	忄	青
惆	周	忄
惇	享	忄
惈	忄	果
惉	心	沾
惊	京	忄
惋	宛	忄
惌	宛	心
惍	忄	金
惎	其	心
惏	忄	林
惐	忄	或
惑	心	或
惒	和	心
惓	卷	忄
惔	忄	炎
惕	忄	易
惖	心	易
惗	忄	念
惘	忄	罔
惙	叕	忄
惚	忄	忽
惛	忄	昏
惜	忄	昔
惝	尚	忄
惞	忄	欣
惟	忄	隹
惠	⑧	心
惡	亞	心
惢	心	𢗰
惣	心	物
惤	弦	忄
惥	心	臾
惦	店	忄
惧	具	忄
惨	参	忄
惩	征	心
惪	心	直
惫	夂	思
惬	匚	夹	忄
惭	忄	斩
惮	单	忄
惯	忄	贯
惰	左	忄	月
惱	忄	𡿺
惲	忄	軍
想	心	相
惴	忄	耑
惵	忄	枼
惶	忄	皇
惷	心	春
惸	㝁	忄
惹	心	若
惺	忄	星
惻	則	忄
惼	忄	扁
惽	忄	昬
惾	㚇	忄
惿	忄	是
愀	忄	秋
愁	心	秋
愂	勃	心
愃	宣	忄
愄	忄	畏
愅	忄	革
愆	心	衍
愇	忄	韋
愈	俞	心
愉	俞	忄
愊	忄	畐
愋	忄	爰
愌	奐	忄
愍	心	敃
愎	复	忄
意	心	音
愐	忄	面
愑	勇	忄
愒	忄	曷
愓	忄	昜
愔	忄	音
愕	咢	忄
愖	忄	甚
愗	心	敄
愘	客	忄
愙	客	心
愚	心	禺
愛	冖	爫	𢖻
愜	匧	忄
愝	匽	忄
愞	忄	耎
感	咸	心
愠	忄	昷
愡	忄	怱
愢	忄	思
愣	忄	𬙙
愤	忄	贲
愥	忄	英
愦	忄	贵
愧	忄	鬼
愨	心	𣪊
愩	忄	貢
愪	員	忄
愫	忄	素
愬	心	朔
愭	忄	耆
愮	䍃	忄
愯	忄	隻
愰	忄	晃
愱	忄	疾
愲	忄	骨
愳	䀠	心
愴	倉	忄
愵	弱	忄
愶	忄	脅
愷	忄	豈
愸	勑	心
愹	容	忄
愺	忄	草
愻	孫	心
愼	忄	眞
愽	尃	忄
愾	忄	氣
愿	原	心
慀	奚	忄
慁	圂	心
慂	心	涌
慃	忄	翁
慄	忄	栗
慅	忄	蚤
慆	忄	舀
慇	心	殷
慈	兹	心
慉	忄	畜
慊	兼	忄
態	心	能
慌	忄	荒
慍	忄	𥁕
慎	忄	真
慏	冥	忄
慐	心	貢
慑	忄	聂
慒	忄	曹
慓	忄	票
慔	忄	莫
慕	㣺	莫
慖	國	忄
慗	心	敕
慘	參	忄
慙	心	斬
慚	忄	斬
慛	崔	忄
慜	心	敏
慝	匿	心
慞	忄	章
慟	動	忄
慠	忄	敖
慡	忄	爽
慢	忄	曼
慣	忄	貫
慤	心	殻
慥	忄	造
慦	心	救
慧	彗	心
慨	忄	既
慩	忄	連
慪	區	忄
慫	從	心
慬	堇	忄
慭	心	𪺽
慮	思	虍
慯	忄	𬀷
慰	尉	心
慱	專	忄
慲	㒼	忄
慳	堅	忄
慴	忄	習
慵	庸	忄
慶	コ	丨	乛	广	𢖻
慷	康	忄
慸	帶	心
慹	執	心
慺	婁	忄
慻	忄	眷
慼	心	戚
慽	忄	戚
慾	心	欲
慿	心	𠗦
憀	忄	翏
憁	忄	悤
憂	㥑	夂
憃	心	舂
憄	徝	心
憅	動	心
憆	堂	忄
憇	心	甜
憈	忄	虚
憉	彭	忄
憊	備	心
憋	心	敝
憌	心	鈞
憍	喬	忄
憎	忄	曾
憏	忄	祭
憐	忄	粦
憑	心	馮
憒	忄	貴
憓	忄	惠
憔	忄	焦
憕	忄	登
憖	心	猌
憗	心	𢽟
憘	喜	忄
憙	喜	心
憚	單	忄
憛	忄	覃
憜	忄	隋
憝	心	敦
憞	忄	敦
憟	忄	粟
憠	厥	心
憡	忄	策
憢	堯	忄
憣	忄	番
憤	忄	賁
憥	勞	心
憦	勞	忄
憧	忄	童
憨	心	敢
憩	心	自	舌
憪	忄	閒
憫	忄	閔
憬	忄	景
憭	尞	忄
憮	忄	無
憯	忄	朁
憰	忄	矞
憱	就	忄
憲	心	罒	𫲸
憳	尋	忄
憴	忄	黽
憵	心	辟
憶	忄	意
憷	忄	楚
憸	僉	忄
憹	忄	農
憺	忄	詹
憻	亶	忄
憼	心	敬
憽	忄	葱
憾	忄	感
憿	忄	敫
懀	忄	會
懁	忄	睘
懂	忄	董
懃	勤	心
懄	勤	忄
懅	忄	豦
懆	喿	忄
懇	心	貇
懈	忄	解
應	䧹	心
懊	奥	忄
懋	心	楙
懌	忄	睪
懍	忄	稟
懎	嗇	忄
懏	忄	雋
懐	亠	忄	𭾱
懑	心	满
懒	忄	赖
懓	忄	愛
懔	忄	禀
懕	厭	心
懖	心	銛
懗	忄	赫
懘	心	滯
懙	忄	與
懚	㥯	忄
懛	忄	臺
懜	夢	忄
懝	忄	疑
懞	忄	蒙
懟	對	心
懠	忄	齊
懡	忄	麽
懢	忄	監
懣	心	滿
懤	壽	忄
懥	忄	疐
懦	忄	需
懧	寧	忄
懨	厭	忄
懩	忄	養
懪	忄	暴
懫	忄	質
懬	廣	心
懭	廣	忄
懮	忄	憂
懯	心	敷
懰	劉	忄
懱	忄	蔑
懲	徵	心
懳	忄	慧
懴	忄	韯
懵	忄	瞢
懶	忄	賴
懷	忄	褱
懸	心	縣
懹	忄	襄
懺	忄	韱
懻	冀	忄
懼	忄	瞿
懽	忄	雚
懾	忄	聶
懿	壹	恣
戀	䜌	心
戁	心	難
戂	忄	靡
戃	忄	黨
戄	忄	矍
戅	心	贑
戆	心	赣
戇	心	贛
戈	丿	弋
戉	戉
戊	戊
戋	一	戈
戌	一	戊
戍	丶	戊
戎	戈	𠂇
戏	又	戈
成	戊	𠃌
我	我
戒	廾	戈
戓	口	戈
戔	戈
戕	戈	爿
或	一	口	戈
戗	仓	戈
战	占	戈
戙	同	戈
戚	尗	戊
戛	戈	𦣻
戜	呈	戈
戝	戈	貝
戞	⑧	戈
戟	戈	𠦝
戠	丷	亠	戈	日
戡	戈	甚
戢	咠	戈
戣	戈	癸
戤	戈	盈
戥	戈	星
戦	単	戈
戧	倉	戈
戨	哥	戈
戩	戈	晉
截	隹	𢦏
戫	或	有
戬	戈	晋
戭	寅	戈
戮	戈	翏
戯	戈	虚
戰	單	戈
戱	戈	虛
戲	䖒	戈
戳	戈	翟
戴	異	𢦏
戵	戈	瞿
戶	丿	尸
户	丶	尸
戸	一	尸
戹	乙	户
戺	巳	户
戻	大	户
戼	戼
戽	户	斗
戾	户	犬
房	户	方
所	戶	斤
扁	户	𠕁
扂	占	户
扃	冋	户
扄	向	户
扅	多	户
扆	户	衣
扇	户	羽
扈	户	邑
扉	户	非
扊	户	炎
手	手
扌	扌
才	才
扎	乚	扌
扏	九	扌
扐	力	扌
扑	卜	扌
扒	八	扌
打	丁	扌
扔	乃	扌
払	厶	扌
扖	入	扌
扗	土	扌
托	乇	扌
扙	丈	扌
扚	勺	扌
扛	工	扌
扜	于	扌
扝	亏	扌
扞	干	扌
扟	卂	扌
扠	叉	扌
扡	也	扌
扢	乞	扌
扣	口	扌
扤	兀	扌
扥	七	丿	扌
扦	千	扌
执	丸	扌
扨	刃	扌
扩	广	扌
扪	扌	门
扫	彐	扌
扬	扌	𠃓
扭	丑	扌
扮	分	扌
扯	扌	止
扰	尤	扌
扱	及	扌
扲	今	扌
扳	反	扌
扴	介	扌
扵	仒	扌
扶	夫	扌
扷	夭	扌
扸	扌	片
批	扌	比
扺	扌	氏
扻	扌	欠
扼	厄	扌
扽	屯	扌
找	戈	扌
承	承
技	扌	支
抁	允	扌
抂	扌	王
抃	卞	扌
抄	少	扌
抅	勾	扌
抆	扌	文
抇	扌	日
抈	扌	月
抉	夬	扌
把	巴	扌
抋	心	扌
抌	冘	扌
抍	升	扌
抎	云	扌
抏	元	扌
抐	内	扌
抑	卬	扌
抒	予	扌
抓	扌	爪
抔	不	扌
投	扌	殳
抖	扌	斗
抗	亢	扌
折	扌	斤
抙	手	扌
抚	扌	无
抛	扌	𠠵
抜	友	扌
抝	幻	扌
択	尺	扌
抟	专	扌
抠	区	扌
抡	仑	扌
抢	仓	扌
抣	匀	扌
护	户	扌
报	扌	𠬝
抦	丙	扌
抧	只	扌
抨	平	扌
抩	冉	扌
抪	布	扌
披	扌	皮
抬	台	扌
抭	宂	扌
抮	㐱	扌
抯	且	扌
抰	央	扌
抱	包	扌
抲	可	扌
抳	尼	扌
抴	世	扌
抵	扌	氐
抶	失	扌
抷	丕	扌
抸	乏	扌
抹	扌	末
抺	扌	未
抻	扌	申
押	扌	甲
抽	扌	由
抾	去	扌
抿	扌	民
拀	兄	扌
拁	加	扌
拂	弗	扌
拃	乍	扌
拄	主	扌
担	扌	旦
拆	扌	斥
拇	扌	母
拈	占	扌
拉	扌	立
拊	付	扌
拋	扌	𡯄
拌	半	扌
拍	扌	白
拎	令	扌
拏	奴	手
拐	另	扌
拑	扌	甘
拒	巨	扌
拓	扌	石
拔	扌	犮
拕	它	扌
拖	㐌	扌
拗	幼	扌
拘	句	扌
拙	出	扌
拚	弁	扌
招	召	扌
拜	一	丰	龵
拝	一	丰	扌
拞	丘	扌
拟	以	扌
拠	処	扌
拡	広	扌
拢	扌	龙
拣	扌	𫠣
拤	卡	扌
拥	扌	用
拦	兰	扌
拧	宁	扌
拨	发	扌
择	扌	𠬤
拪	扌	西
拫	扌	艮
括	扌	舌
拭	式	扌
拮	吉	扌
拯	丞	扌
拰	任	扌
拱	共	扌
拲	共	手
拳	手	龹
拴	全	扌
拵	存	扌
拶	扌	𡿪
拷	扌	考
拸	多	扌
拹	劦	扌
拺	扌	朿
拻	扌	灰
拼	并	扌
拽	扌	曳
拾	合	扌
拿	合	手
挀	扌	𠂢
持	寺	扌
挂	圭	扌
挃	扌	至
挄	光	扌
挅	扌	朶
挆	扌	朵
指	扌	旨
挈	㓞	手
按	安	扌
挊	扌	𠧗
挋	扌	臣
挌	各	扌
挍	交	扌
挎	夸	扌
挏	同	扌
挐	如	手
挑	兆	扌
挒	列	扌
挓	宅	扌
挔	扌	衣
挕	扌	耳
挖	扌	穵
挗	夷	扌
挘	劣	扌
挙	兴	手
挚	手	执
挛	亦	手
挜	亚	扌
挝	扌	过
挞	扌	达
挟	夹	扌
挠	尧	扌
挡	当	扌
挢	乔	扌
挣	争	扌
挤	扌	齐
挥	军	扌
挦	寻	扌
挧	扌	羽
挨	扌	矣
挩	兌	扌
挪	扌	那
挫	坐	扌
挬	孛	扌
挭	扌	更
挮	弟	扌
振	扌	辰
挰	呈	扌
挱	扌	沙
挲	手	沙
挳	巠	扌
挴	扌	每
挵	弄	扌
挶	局	扌
挷	扌	邦
挸	扌	見
挹	扌	邑
挺	廷	扌
挻	延	扌
挼	妥	扌
挽	免	扌
挾	夾	扌
挿	扌	𢆍
捀	夆	扌
捁	告	扌
捂	吾	扌
捃	君	扌
捄	扌	求
捅	扌	甬
捆	困	扌
捇	扌	赤
捈	余	扌
捉	扌	足
捊	孚	扌
捋	寽	扌
捌	别	扌
捍	扌	旱
捎	扌	肖
捏	圼	扌
捐	扌	肙
捑	扌	𣅔
捒	扌	束
捓	扌	邪
捔	扌	角
捕	扌	甫
捖	完	扌
捗	扌	步
捘	夋	扌
捙	扌	車
捚	扌	里
捛	吕	扌
捜	扌	叟
捝	兑	扌
捞	劳	扌
损	员	扌
捠	兵	扌
捡	佥	扌
换	奂	扌
捣	岛	扌
捤	尾	扌
捥	宛	扌
捦	扌	金
捧	奉	扌
捨	扌	舍
捩	戾	扌
捪	扌	昏
捫	扌	門
捬	府	扌
捭	卑	扌
据	居	扌
捯	到	扌
捰	扌	果
捱	厓	扌
捲	卷	扌
捳	岳	扌
捴	忩	扌
捵	典	扌
捶	垂	扌
捷	扌	疌
捸	扌	隶
捹	奔	扌
捺	奈	扌
捻	念	扌
捼	委	扌
捽	卒	扌
捾	官	扌
捿	妻	扌
掀	扌	欣
掁	扌	長
掂	店	扌
掃	帚	扌
掄	侖	扌
掅	扌	青
掆	岡	扌
掇	叕	扌
授	受	扌
掉	卓	扌
掊	咅	扌
掋	底	扌
掌	手	𫩠
掍	扌	昆
掎	奇	扌
掏	匋	扌
掐	扌	臽
掑	其	扌
排	扌	非
掓	叔	扌
掔	手	臤
掕	夌	扌
掖	夜	扌
掗	亞	扌
掘	屈	扌
掙	扌	爭
掚	兩	扌
掛	卦	扌
掜	兒	扌
掝	或	扌
掞	扌	炎
掟	定	扌
掠	京	扌
採	扌	采
探	扌	罙
掣	制	手
掤	扌	朋
接	妾	扌
掦	扌	易
控	扌	空
推	扌	隹
掩	奄	扌
措	扌	昔
掫	取	扌
掬	匊	扌
掭	忝	扌
掮	扌	肩
掯	扌	肯
掰	分	手	龵
掱	手	𢪒
掲	匂	扌	日
掳	扌	虏
掴	国	扌
掵	命	扌
掶	庚	扌
掷	扌	郑
掸	单	扌
掹	孟	扌
掺	参	扌
掻	扌	𧈡
掼	扌	贯
掽	並	扌
掾	彖	扌
掿	扌	若
揀	扌	柬
揁	扌	貞
揂	扌	酋
揃	前	扌
揄	俞	扌
揅	手	研
揆	扌	癸
揇	南	扌
揈	扌	訇
揉	扌	柔
揊	扌	畐
揋	扌	畏
揌	思	扌
揍	奏	扌
揎	宣	扌
描	扌	苗
提	扌	是
揑	扌	𬛸
插	扌	臿
揓	扌	施
揔	怱	扌
揕	扌	甚
揖	咠	扌
揗	扌	盾
揘	扌	皇
揙	扁	扌
揚	扌	昜
換	奐	扌
揜	弇	扌
揝	扌	昝
揞	扌	音
揟	扌	胥
揠	匽	扌
握	屋	扌
揢	客	扌
揣	扌	耑
揤	即	扌
揥	帝	扌
揦	剌	扌
揧	剌	手
揨	亭	扌
揩	扌	皆
揪	扌	秋
揫	手	秋
揬	扌	突
揭	扌	曷
揮	扌	軍
揯	恆	扌
揰	扌	重
揱	削	手
揲	扌	枼
揳	契	扌
援	扌	爰
揵	建	扌
揶	扌	耶
揷	扌	𢆍
揸	扌	查
揹	扌	背
揺	扌	爫	𠙻
揻	威	扌
揼	扌	泵
揽	扌	览
揾	扌	昷
揿	扌	钦
搀	扌	𫥎
搁	扌	阁
搂	娄	扌
搃	总	扌
搄	恒	扌
搅	扌	觉
搆	冓	扌
搇	扌	衾
搈	容	扌
搉	扌	隺
搊	扌	芻
搋	扌	虒
搌	展	扌
損	員	扌
搎	孫	扌
搏	尃	扌
搐	扌	畜
搑	扌	茸
搒	扌	旁
搓	差	扌
搔	扌	蚤
搕	扌	盍
搖	䍃	扌
搗	島	扌
搘	扌	耆
搙	扌	辱
搚	扌	脅
搛	兼	扌
搜	叟	扌
搝	扌	臭
搞	扌	高
搟	扌	軒
搠	扌	朔
搡	扌	桑
搢	扌	晋
搣	扌	烕
搤	扌	益
搥	扌	追
搦	弱	扌
搧	扇	扌
搨	扌	𦐇
搩	扌	桀
搪	唐	扌
搫	手	般
搬	扌	般
搭	扌	荅
搮	扌	栗
搯	扌	舀
搰	扌	骨
搱	屖	扌
搲	扌	窊
搳	害	扌
搴	手	𡨄
搵	扌	𥁕
搶	倉	扌
搷	扌	真
搸	扌	秦
搹	扌	鬲
携	扌	隽
搻	合	𢪒
搼	扌	拳
搽	扌	茶
搾	扌	窄
搿	合	手	龵
摀	扌	烏
摁	恩	扌
摂	丷	八	扌	耳
摃	扌	貢
摄	扌	聂
摅	扌	虑
摆	扌	罢
摇	䍃	扌
摈	宾	扌
摉	扌	𡨝
摊	扌	难
摋	扌	殺
摌	扌	産
摍	宿	扌
摎	扌	翏
摏	扌	舂
摐	從	扌
摑	國	扌
摒	屏	扌
摓	扌	逢
摔	扌	率
摕	帶	扌
摖	扌	祭
摗	扌	欶
摘	啇	扌
摙	扌	連
摚	堂	扌
摛	扌	离
摜	扌	貫
摝	扌	鹿
摞	扌	累
摟	婁	扌
摠	悤	扌
摡	扌	既
摢	扌	虖
摣	扌	虘
摤	扌	爽
摥	扌	𬀷
摦	扌	瓠
摧	崔	扌
摨	扌	犀
摩	手	麻
摪	將	扌
摫	扌	規
摬	扌	竟
摭	庶	扌
摮	手	敖
摯	執	手
摰	埶	手
摱	扌	曼
摲	扌	斬
摳	區	扌
摴	扌	雩
摵	戚	扌
摶	專	扌
摷	巢	扌
摸	扌	莫
摹	手	莫
摺	扌	習
摻	參	扌
摼	堅	扌
摽	扌	票
摾	强	扌
摿	人	扌	音
撀	手	殸
撁	扌	牽
撂	扌	畧
撃	手	軗
撄	婴	扌
撅	厥	扌
撆	手	敝
撇	扌	敝
撈	勞	扌
撉	手	敦
撊	扌	閒
撋	扌	閏
撌	扌	貴
撍	扌	朁
撎	壹	扌
撏	尋	扌
撐	扌	牚
撑	扌	掌
撒	扌	散
撓	堯	扌
撔	扌	景
撕	扌	斯
撖	扌	敢
撗	扌	黄
撘	扌	答
撙	尊	扌
撚	扌	然
撛	扌	粦
撜	扌	登
撝	扌	爲
撞	扌	童
撟	喬	扌
撠	戟	扌
撡	叅	扌
撢	扌	覃
撣	單	扌
撤	扌	攵	育
撥	扌	發
撦	奢	扌
撧	扌	絕
撨	扌	焦
撩	尞	扌
撪	扌	軬
撫	扌	無
撬	扌	毳
播	扌	番
撮	扌	最
撯	扌	着
撰	巽	扌
撱	扌	隋
撲	扌	菐
撳	扌	欽
撴	扌	敦
撵	扌	辇
撶	扌	華
撷	扌	颉
撸	扌	鲁
撹	扌	覚
撺	扌	窜
撻	扌	達
撼	感	扌
撽	扌	敫
撾	扌	過
撿	僉	扌
擀	幹	扌
擁	扌	雍
擂	扌	雷
擃	扌	農
擄	扌	虜
擅	亶	扌
擆	扌	著
擇	扌	睪
擈	扌	業
擉	扌	蜀
擊	手	𣪠
擋	扌	當
擌	扌	筴
操	喿	扌
擎	手	敬
擏	扌	敬
擐	扌	睘
擑	戢	扌
擒	扌	禽
擓	匯	扌
擔	扌	詹
擕	扌	雋
擖	扌	葛
擗	扌	辟
擘	手	辟
擙	奧	扌
據	扌	豦
擛	扌	葉
擜	扌	献
擝	扌	盟
擞	扌	数
擟	扌	爾
擠	扌	齊
擡	扌	臺
擢	扌	翟
擣	壽	扌
擤	扌	鼻
擥	一	手	罒	臣	𠂉
擦	察	扌
擧	手	與
擨	扌	歋
擩	扌	需
擪	厭	手
擫	厭	扌
擬	扌	疑
擭	扌	蒦
擮	截	扌
擯	扌	賓
擰	寧	扌
擱	扌	閣
擲	扌	鄭
擳	扌	節
擴	廣	扌
擵	扌	摩
擶	扌	箭
擷	扌	頡
擸	巤	扌
擹	扌	歎
擺	扌	罷
擻	扌	數
擼	扌	魯
擽	扌	樂
擾	憂	扌
擿	扌	適
攀	手	樊
攁	扌	養
攂	扌	畾
攃	扌	蔡
攄	慮	扌
攅	扌	賛
攆	扌	輦
攇	憲	扌
攈	扌	麇
攉	扌	霍
攊	扌	歷
攋	扌	賴
攌	圜	扌
攍	嬴	扌
攎	扌	盧
攏	扌	龍
攐	扌	褰
攑	扌	舉
攒	扌	赞
攓	扌	蹇
攔	扌	闌
攕	扌	韱
攖	嬰	扌
攗	扌	麋
攘	扌	襄
攙	扌	毚
攚	扌	營
攛	扌	竄
攜	巂	扌
攝	扌	聶
攞	扌	羅
攟	扌	麕
攠	扌	靡
攡	扌	離
攢	扌	贊
攣	䜌	手
攤	扌	難
攥	扌	纂
攦	扌	麗
攧	扌	顛
攨	㼌	扌	瓜	穴
攩	扌	黨
攪	扌	覺
攫	扌	矍
攬	扌	覽
攭	扌	蠡
攮	囊	扌
支	十	又
攰	力	支
攱	支	立
攲	奇	支
攳	尋	支
攴	⺊	又
攵	攵
收	丩	攵
攷	丂	攵
攸	丨	亻	攵
改	己	攵
攺	巳	攵
攻	工	攵
攼	干	攵
攽	分	攵
放	攵	方
政	攵	正
敀	攵	白
敁	占	攴
敂	句	攵
敃	攵	民
敄	攵	矛
故	古	攵
敆	合	攴
敇	攵	朿
效	交	攵
敉	攵	米
敊	尗	攴
敋	各	攵
敌	攵	舌
敍	余	攴
敎	攵	𡥉
敏	攵	每
敐	攵	辰
救	攵	求
敒	伸	攵
敓	兌	攵
敔	吾	攵
敕	攵	束
敖	攵	𫠤
敗	攵	貝
敘	余	攵
教	孝	攵
敚	兑	攵
敛	佥	攵
敜	念	攵
敝	㡀	攵
敞	尚	攵
敟	典	攵
敠	叕	攴
敡	攴	易
敢	乛	攵	耳
散	⺼	攵	龷
敤	攴	果
敥	攴	炎
敦	享	攵
敧	奇	攴
敨	咅	攵
敩	学	攵
敪	叕	攵
敫	攵	方	白
敬	攵	苟
敭	攵	昜
敮	攴	臿
敯	攴	昬
数	娄	攵
敱	攴	豈
敲	攴	高
敳	攵	豈
整	敕	正
敵	啇	攵
敶	攵	陳
敷	攵	旉
數	婁	攵
敹	攵	𥹄
敺	區	攴
敻	攵	目	𠂊	𠔿
敼	喜	攴
敽	喬	攴
敾	善	攵
敿	喬	攵
斀	攴	蜀
斁	攵	睪
斂	僉	攵
斃	敝	死
斄	來	𠩺
斅	學	攴
斆	學	攵
文	乂	亠
斈	子	文
斉	丨	丿	二	文
斊	文	耳
斋	文	而
斌	文	武
斍	文	見
斎	示	齐
斏	文	良
斐	文	非
斑	文	王
斒	扁	文
斓	文	阑
斔	臾	蚉
斕	文	闌
斖	文	舋
斗	斗
斘	夕	斗
料	斗	米
斚	冖	厸	斗
斛	斗	角
斜	余	斗
斝	冖	吅	斗
斞	斗	臾
斟	斗	甚
斠	冓	斗
斡	人	斗	𠦝
斢	斗	黄
斣	斗	蜀
斤	丅	𠂆
斥	丶	斤
斦	斤
斧	斤	父
斨	斤	爿
斩	斤	车
斪	句	斤
斫	斤	石
斬	斤	車
断	斤	米	𠃊
斮	斤	昔
斯	其	斤
新	亲	斤
斱	斤	者
斲	斤	𠁁
斳	堇	斤
斴	斤	粦
斵	③	亞	刀	斤
斶	斤	蜀
斷	㡭	斤
斸	屬	斤
方	丿	亠	𠃌
斺	介	方
斻	几	方	𠂉
於	仒	方
施	㐌	方
斾	巾	方	𠂉
斿	子	方	𠂉
旀	厼	方
旁	丷	亠	冖	方
旂	斤	方	𠂉
旃	丹	方	𠂉
旄	方	毛	𠂉
旅	④	方	𠂉
旆	巿	方	𠂉
旇	方	皮	𠂉
旈	㐬	方
旉	方	甫
旊	方	瓦	𠂉
旋	方	𭻾
旌	方	生	𠂉
旍	令	方	𠂉
旎	尼	方	𠂉
族	方	矢	𠂉
旐	兆	方	𠂉
旑	奇	方
旒	㐬	方	𠂉
旓	方	肖	𠂉
旔	建	方
旕	叱	於
旖	奇	方	𠂉
旗	其	方	𠂉
旘	戠	方
旙	方	番
旚	方	票	𠂉
旛	方	番	𠂉
旜	亶	方	𠂉
旝	方	會	𠂉
旞	方	遂	𠂉
旟	方	與	𠂉
无	一	尢
旡	旡
既	⑤	旡
旣	旡	皀
旤	咼	旡
日	日
旦	一	日
旧	丨	日
旨	匕	日
早	十	日
旪	十	日
旫	刀	日
旬	勹	日
旭	九	日
旮	九	日
旯	九	日
旰	干	日
旱	干	日
旲	大	日
旳	勺	日
旴	于	日
旵	山	日
时	寸	日
旷	广	日
旸	日	𠃓
旹	㞢	日
旺	日	王
旻	文	日
旼	文	日
旽	屯	日
旾	屯	日
旿	午	日
昀	匀	日
昁	巿	日
昂	卬	日
昃	仄	日
昄	反	日
昅	及	日
昆	日	比
昇	升	日
昈	户	日
昉	方	日
昊	天	日
昋	天	日
昌	日
昍	日
明	日	月
昏	日	氏
昐	分	日
昑	今	日
昒	勿	日
易	勿	日
昔	日	龷
昕	斤	日
昖	公	日
昗	六	日
昘	方	日
昙	云	日
昚	日	𡗜
昛	巨	日
昜	勿	旦
昝	处	日
昞	丙	日
星	日	生
映	央	日
昡	日	玄
昢	出	日
昣	㐱	日
昤	令	日
春	日	𡗗
昦	夰	日
昧	日	未
昨	乍	日
昩	日	末
昪	弁	日
昫	句	日
昬	日	民
昭	召	日
昮	功	日
是	日	𤴓
昰	日	正
昱	日	立
昲	弗	日
昳	失	日
昴	卯	日
昵	尼	日
昶	日	永
昷	日	皿
昸	冬	日
昹	日	永
昺	丙	日
昻	卭	日
昼	尺	旦
昽	日	龙
显	业	日
昿	広	日
晀	兆	日
晁	兆	日
時	寺	日
晃	光	日
晄	光	日
晅	亘	日
晆	圭	日
晇	夸	日
晈	交	日
晉	一	厸	日
晊	日	至
晋	亚	日
晌	向	日
晍	同	日
晎	共	日
晏	安	日
晐	亥	日
晑	向	日
晒	日	西
晓	尧	日
晔	华	日
晕	军	日
晖	军	日
晗	含	日
晘	日	旱
晙	夋	日
晚	免	日
晛	日	見
晜	弟	日
晝	一	旦	𦘒
晞	希	日
晟	成	日
晠	成	日
晡	日	甫
晢	折	日
晣	折	日
晤	吾	日
晥	完	日
晦	日	每
晧	告	日
晨	日	辰
晩	免	日
晪	典	日
晫	卓	日
晬	卒	日
晭	周	日
普	並	日
景	京	日
晰	日	析
晱	日	炎
晲	兒	日
晳	日	析
晴	日	青
晵	日	𢼄
晶	日	昍
晷	咎	日
晸	政	日
晹	日	易
智	日	知
晻	奄	日
晼	宛	日
晽	日	林
晾	京	日
晿	日	昌
暀	往	日
暁	尭	日
暂	斩	日
暃	日	非
暄	宣	日
暅	恒	日
暆	施	日
暇	叚	日
暈	日	軍
暉	日	軍
暊	日	頁
暋	敃	日
暌	日	癸
暍	日	曷
暎	日	英
暏	日	者
暐	日	韋
暑	日	者
暒	日	星
暓	敄	日
暔	南	日
暕	日	柬
暖	日	爰
暗	日	音
暘	日	昜
暙	日	春
暚	䍃	日
暛	差	日
暜	日	竝
暝	冥	日
暞	日	臬
暟	日	豈
暠	日	高
暡	日	翁
暢	昜	申
暣	日	氣
暤	日	皋
暥	日	晏
暦	日	𠩵
暧	日	爱
暨	既	旦
暩	日	祭
暪	㒼	日
暫	斬	日
暬	埶	日
暭	日	皐
暮	日	莫
暯	日	莫
暰	從	日
暱	匿	日
暲	日	章
暳	彗	日
暴	㳟	日
暵	口	夫	廿	日
暶	旋	日
暷	專	日
暸	尞	日
暹	日	辶	隹
暺	單	日
暻	日	景
暼	敝	日
暽	日	粦
暾	敦	日
暿	喜	日
曀	壹	日
曁	旣	旦
曂	日	黄
曃	日	逮
曄	日	華
曅	日	華
曆	厤	日
曇	日	雲
曈	日	童
曉	堯	日
曊	日	費
曋	日	覃
曌	明	空
曍	日	臯
曎	日	睪
曏	日	鄉
曐	晶	生
曑	㐱	晶
曒	敫	日
曓	大	夲	𣅽
曔	敬	日
曕	日	詹
曖	愛	日
曗	日	業
曘	日	需
曙	日	署
曚	日	蒙
曛	日	熏
曜	日	翟
曝	日	暴
曞	厲	日
曟	晶	辰
曠	廣	日
曡	冝	晶
曢	寮	日
曣	日	燕
曤	日	霍
曥	日	盧
曦	日	羲
曧	日	融
曨	日	龍
曩	日	襄
曪	日	羅
曫	䜌	日
曬	日	麗
曭	日	黨
曮	嚴	日
曯	屬	日
曰	曰
曱	曱
曲	曲
曳	曳
更	一	乂	日
曵	丶	曳
曶	勿	曰
曷	匃	日
書	一	日	𦘒
曹	一	日	曲
曺	日	𤰔
曻	曰	舛
曼	又	日	罒
曽	日	𬎿
曾	丷	𭥴
替	㚘	日
最	取	日
朁	兓	日
朂	力	日	耳
會	亼	𭥴
朄	柬	申
朅	去	曷
朆	勿	曾
朇	卑	會
月	月
有	月	𠂇
朊	元	月
朋	月
朌	分	月
服	月	𠬝
朎	令	月
朏	出	月
朐	句	月
朑	世	月
朒	月	肉
朓	兆	月
朔	屰	月
朕	关	月
朖	月	良
朗	⑤	丶	月
朘	夋	月
朙	囧	月
朚	亡	明
望	亡	月	王
朜	享	月
朝	月	𠦝
朞	其	月
期	其	月
朠	月	英
朡	㚇	月
朢	月	王	臣
朣	月	童
朤	朋
朥	勞	月
朦	月	蒙
朧	月	龍
木	木
朩	朩
未	未
末	末
本	本
札	乚	木
朮	丶	𣎳
术	丶	木
朰	乙	木
朱	朱
朲	人	木
朳	八	木
朴	卜	木
朵	几	木
朶	乃	木
朷	刀	木
朸	力	木
朹	九	木
机	几	木
朻	丩	木
朼	匕	木
朽	丂	木
朾	丁	木
朿	朿
杀	㐅	朩
杁	入	木
杂	九	朩
权	又	木
杄	千	木
杅	于	木
杆	干	木
杇	亏	木
杈	叉	木
杉	彡	木
杊	川	木
杋	凡	木
杌	兀	木
杍	子	木
李	子	木
杏	口	木
材	才	木
村	寸	木
杒	刃	木
杓	勺	木
杔	乇	木
杕	大	木
杖	丈	木
杗	亡	木
杘	尸	木
杙	弋	木
杚	乞	木
杛	弓	木
杜	土	木
杝	也	木
杞	己	木
束	束
杠	工	木
条	夂	朩
杢	工	木
杣	山	木
杤	万	木
来	来
杦	久	木
杧	亡	木
杨	木	𠃓
杩	木	马
杪	少	木
杫	木	止
杬	元	木
杭	亢	木
杮	巿	木
杯	不	木
杰	木	灬
東	東
杲	日	木
杳	日	木
杴	木	欠
杵	午	木
杶	屯	木
杷	巴	木
杸	木	殳
杹	化	木
杺	心	木
杻	丑	木
杼	予	木
杽	手	木
松	公	木
板	反	木
枀	公	木
极	及	木
枂	月	木
枃	匀	木
构	勾	木
枅	开	木
枆	木	毛
枇	木	比
枈	木	比
枉	木	王
枊	卬	木
枋	方	木
枌	分	木
枍	兮	木
枎	夫	木
枏	冄	木
析	斤	木
枑	互	木
枒	木	牙
枓	斗	木
枔	今	木
枕	冘	木
枖	夭	木
林	木
枘	内	木
枙	厄	木
枚	攵	木
枛	木	爪
果	日	木
枝	支	木
枞	从	木
枟	云	木
枠	卆	木
枡	升	木
枢	区	木
枣	⺀	朿
枤	木	犬
枥	历	木
枦	户	木
枧	木	见
枨	木	长
枩	公	木
枪	仓	木
枫	木	风
枬	丹	木
枭	④	木
枮	占	木
枯	古	木
枰	平	木
枱	台	木
枲	台	木
枳	只	木
枴	叧	木
枵	号	木
架	加	木
枷	加	木
枸	句	木
枹	包	木
枺	木	末
枻	世	木
枼	世	木
枽	卋	木
枾	⑤	木
枿	卉	木
柀	木	皮
柁	它	木
柂	㐌	木
柃	令	木
柄	丙	木
柅	尼	木
柆	木	立
柇	木	禾
柈	半	木
柉	乏	木
柊	冬	木
柋	代	木
柌	司	木
柍	央	木
柎	付	木
柏	木	白
某	木	甘
柑	木	甘
柒	㲺	木
染	木	氿
柔	木	矛
柕	木	矛
柖	召	木
柗	㕣	木
柘	木	石
柙	木	甲
柚	木	由
柛	木	申
柜	巨	木
柝	斥	木
柞	乍	木
柟	冉	木
柠	宁	木
柡	二	木	水
柢	木	氐
柣	失	木
柤	且	木
查	旦	木
柦	旦	木
柧	木	瓜
柨	布	木
柩	匛	木
柪	幼	木
柫	弗	木
柬	柬
柭	木	犮
柮	出	木
柯	可	木
柰	木	示
柱	主	木
柲	必	木
柳	卯	木
柴	木	此
柵	冊	木
柶	四	木
柷	兄	木
柸	丕	木
柹	木	𠂔
柺	另	木
査	且	木
柼	木	穴
柽	圣	木
柾	木	正
柿	市	木
栀	卮	木
栁	夘	木
栂	木	母
栃	万	木	𠂆
栄	冖	木	𭕄
栅	册	木
栆	⺀	口	大
标	木	示
栈	戋	木
栉	木	节
栊	木	龙
栋	东	木
栌	卢	木
栍	木	生
栎	乐	木
栏	兰	木
栐	木	永
树	对	木
栒	旬	木
栓	全	木
栔	㓞	木
栕	木	臣
栖	木	西
栗	木	覀
栘	多	木
栙	夅	木
栚	关	木
栛	劦	木
栜	木	朿
栝	木	舌
栞	幵	木
栟	并	木
栠	任	木
校	交	木
栢	木	百
栣	任	木
栤	冰	木
栥	木	次
栦	州	木
栧	曳	木
栨	木	次
栩	木	羽
株	木	朱
栫	存	木
栬	木	色
栭	木	而
栮	木	耳
栯	有	木
栰	伐	木
栱	共	木
栲	木	考
栳	木	老
栴	丹	木	𠂉
栵	列	木
栶	因	木
样	木	羊
核	亥	木
根	木	艮
栺	旨	木
栻	式	木
格	各	木
栽	木	𢦏
栾	亦	木
栿	伏	木
桀	木	舛
桁	木	行
桂	圭	木
桃	兆	木
桄	光	木
桅	危	木
框	匡	木
桇	如	木
案	安	木
桉	安	木
桊	木	𠔉
桋	夷	木
桌	⺊	杲
桍	夸	木
桎	木	至
桏	木	邛
桐	同	木
桑	叒	木
桒	卉	木
桓	亘	木
桔	吉	木
桕	木	臼
桖	木	血
桗	木	朶
桘	木	𠂤
桙	木	牟
桚	木	𡿪
桛	木	𠧗
桜	女	木	𭕄
桝	木	舛
桞	木	邜
桟	㦮	木
桠	亚	木
桡	尧	木
桢	木	贞
档	当	木
桤	岂	木
桥	乔	木
桦	华	木
桧	会	木
桨	丬	夕	木
桩	庄	木
桪	寻	木
桫	木	沙
桬	木	沙
桭	木	辰
桮	否	木
桯	呈	木
桰	木	𠯑
桱	巠	木
桲	孛	木
桳	厶	夲	木
桴	孚	木
桵	妥	木
桶	木	甬
桷	木	角
桸	希	木
桹	木	良
桺	丣	木
桻	夆	木
桼	人	木	氺
桽	坐	木
桾	君	木
桿	旱	木
梀	木	束
梁	刅	木	氵
梂	木	求
梃	廷	木
梄	木	酉
梅	木	每
梆	木	邦
梇	弄	木
梈	亨	木
梉	壯	木
梊	折	木
梋	木	肙
梌	余	木
梍	木	皂
梎	木	皀
梏	告	木
梐	坒	木
梑	木	狄
梒	含	木
梓	木	辛
梔	巵	木
梕	忍	木
梖	木	貝
梗	更	木
梘	木	見
梙	串	木
梚	免	木
梛	木	那
梜	夾	木
條	丨	亻	条
梞	忌	木
梟	⑦	木
梠	吕	木
梡	完	木
梢	木	肖
梣	岑	木
梤	木	𡵳
梥	宀	枀
梦	夕	林
梧	吾	木
梨	利	木
梩	木	里
梪	木	豆
梫	木	𠬶
梬	木	甹
梭	夋	木
梮	局	木
梯	弟	木
械	戒	木
梱	困	木
梲	兌	木
梳	㐬	木
梴	延	木
梵	凡	林
梶	尾	木
梷	占	又	木
梸	利	木
梹	兵	木
梺	下	林
梻	佛	木
梼	寿	木
梽	志	木
梾	木	来
梿	木	连
检	佥	木
棁	兑	木
棂	木	灵
棃	木	𥝢
棄	廿	木	𠫓
棅	木	秉
棆	侖	木
棇	忩	木
棈	木	青
棉	帛	木
棊	其	木
棋	其	木
棌	木	采
棍	昆	木
棎	木	罙
棏	㝵	木
棐	木	非
棑	木	非
棒	奉	木
棓	咅	木
棔	昏	木
棕	宗	木
棖	木	長
棗	朿
棘	朿
棙	戾	木
棚	朋	木
棛	木	育
棜	於	木
棝	固	木
棞	囷	木
棟	木	東
棠	木	𫩠
棡	岡	木
棢	木	罔
棣	木	隶
棤	昔	木
棥	木	爻
棦	木	爭
棧	戔	木
棨	木	𢼄
棩	木	𣶒
棪	木	炎
棫	或	木
棬	卷	木
棭	夜	木
森	木	林
棯	念	木
棰	垂	木
棱	夌	木
棲	妻	木
棳	叕	木
棴	服	木
棵	木	果
棶	來	木
棷	取	木
棸	取	木
棹	卓	木
棺	官	木
棻	木	芬
棼	分	林
棽	今	林
棾	冗	林
棿	兒	木
椀	宛	木
椁	享	木
椂	录	木
椃	木	虎
椄	妾	木
椅	奇	木
椆	周	木
椇	具	木
椈	匊	木
椉	亠	桀
椊	卒	木
椋	京	木
椌	木	空
植	木	直
椎	木	隹
椏	亞	木
椐	居	木
椑	卑	木
椒	叔	木
椓	木	豖
椔	木	甾
椕	分	木
椖	房	木
椗	定	木
椘	之	林
椙	昌	木
椚	木	門
椛	木	花
検	㑒	木
椝	木	规
椞	木	析
椟	卖	木
椠	斩	木
椡	到	木
椢	国	木
椣	典	木
椤	木	罗
椥	木	知
椦	劵	木
椧	命	木
椨	府	木
椩	庚	木
椪	並	木
椫	单	木
椬	宜	木
椭	木	陏
椮	参	木
椯	木	耑
椰	木	耶
椱	复	木
椲	木	韋
椳	木	畏
椴	木	段
椵	叚	木
椶	㚇	木
椷	咸	木
椸	施	木
椹	木	甚
椺	保	木
椻	匽	木
椼	木	衍
椽	彖	木
椾	前	木
椿	春	木
楀	木	禹
楁	客	木
楂	木	查
楃	屋	木
楄	扁	木
楅	木	畐
楆	木	要
楇	咼	木
楈	木	胥
楉	木	若
楊	昜	木
楋	剌	木
楌	彦	木
楍	木	𠱠
楎	木	軍
楏	奎	木
楐	木	界
楑	木	癸
楒	思	木
楓	木	風
楔	契	木
楕	左	月	木
楖	即	木
楗	建	木
楘	敄	木
楙	木	矛
楚	林	疋
楛	木	苦
楜	木	胡
楝	木	柬
楞	木	𬙙
楟	亭	木
楠	南	木
楡	兪	木
楢	木	酋
楣	木	眉
楤	怱	木
楥	木	爰
楦	宣	木
楧	木	英
楨	木	貞
楩	便	木
楪	木	枼
楫	咠	木
楬	曷	木
業	业	𦍎
楮	木	者
楯	木	盾
楰	木	臾
楱	奏	木
楲	威	木
楳	木	某
楴	帝	木
極	亟	木
楶	呆	次
楷	木	皆
楸	木	秋
楹	木	盈
楺	木	柔
楻	木	皇
楼	娄	木
楽	丷	八	木	白
楾	木	泉
楿	木	香
榀	品	木
榁	室	木
概	既	木
榃	林	田
榄	木	览
榅	昷	木
榆	俞	木
榇	亲	木
榈	木	闾
榉	举	木
榊	木	神
榋	彐	木
榌	木	飛
榍	屑	木
榎	夏	木
榏	木	益
榐	展	木
榑	尃	木
榒	弱	木
榓	木	𥁑
榔	木	郎
榕	容	木
榖	一	冖	士	木	殳
榗	晋	木
榘	木	矩
榙	木	荅
榚	木	羔
榛	木	秦
榜	旁	木
榝	木	殺
榞	原	木
榟	宰	木
榠	冥	木
榡	木	素
榢	家	木
榣	䍃	木
榤	木	桀
榥	晃	木
榦	人	木	𠦝
榧	匪	木
榨	木	窄
榩	木	虔
榪	木	馬
榫	木	隼
榬	木	袁
榭	射	木
榮	木	𤇾
榯	時	木
榰	木	耆
榱	木	衰
榲	木	𥁕
榳	庭	木
榴	木	留
榵	木	茸
榶	唐	木
榷	木	隺
榸	埋	木
榹	木	虒
榺	月	桊
榻	木	𦐇
榼	木	盍
榽	奚	木
榾	木	骨
榿	木	豈
槀	木	高
槁	木	高
槂	孫	木
槃	木	般
槄	木	舀
槅	木	鬲
槆	木	荀
槇	木	眞
槈	木	辱
槉	木	疾
槊	朔	木
構	冓	木
槌	木	追
槍	倉	木
槎	差	木
槏	兼	木
槐	木	鬼
槑	呆
槒	木	畜
槓	木	貢
槔	木	皋
槕	木	桌
槖	木	𥑟
槗	木	𠳮
様	木	𣴎
槙	木	真
槚	木	贾
槛	木	监
槜	木	隽
槝	島	木
槞	木	竜
槟	宾	木
槠	木	诸
槡	木	桑
槢	木	習
槣	寄	木
槤	木	連
槥	彗	木
槦	庸	木
槧	斬	木
槨	木	郭
槩	既	木
槪	旣	木
槫	專	木
槬	木	瓠
槭	戚	木
槮	參	木
槯	崔	木
槰	木	逢
槱	木	灬	酉
槲	斛	木
槳	將	木
槴	扈	木
槵	患	木
槶	國	木
槷	埶	木
槸	埶	木
槹	木	皐
槺	康	木
槻	木	規
槼	木	規
槽	曹	木
槾	曼	木
槿	堇	木
樀	啇	木
樁	木	舂
樂	幺	木	白
樃	朗	木
樄	木	陳
樅	從	木
樆	木	离
樇	木	脩
樈	木	竟
樉	木	爽
樊	大	棥
樋	木	通
樌	木	貫
樍	木	責
樎	宿	木
樏	木	累
樐	木	鹵
樑	木	梁
樒	密	木
樓	婁	木
樔	巢	木
樕	木	欶
樖	合	柯
樗	木	雩
樘	堂	木
標	木	票
樚	木	鹿
樛	木	翏
樜	庶	木
樝	木	虘
樞	區	木
樟	木	章
樠	㒼	木
模	木	莫
樢	木	鳥
樣	木	羕
樤	木	條
樥	木	莑
樦	䇠	木
樧	木	殺
樨	木	犀
権	木	𮥶
横	木	黄
樫	堅	木
樬	悤	木
樭	基	木
樮	䙳	木
樯	啬	木
樰	木	雪
樱	婴	木
樲	木	貳
樳	尋	木
樴	戠	木
樵	木	焦
樶	最	木
樷	取	林
樸	木	菐
樹	尌	木
樺	木	華
樻	木	貴
樼	孱	木
樽	尊	木
樾	木	越
樿	單	木
橀	㐬	木	皿
橁	木	筍
橂	奠	木
橃	木	發
橄	敢	木
橅	木	無
橆	一	卌	林	𠂉
橇	木	毳
橈	堯	木
橉	木	粦
橊	木	畱
橋	喬	木
橌	木	閒
橍	木	閏
橎	木	番
橏	善	木
橐	䂞	一	中	冖
橑	尞	木
橒	木	雲
橓	木	舜
橔	敦	木
橕	木	牚
橖	木	棠
橗	木	萌
橘	木	矞
橙	木	登
橚	木	肅
橛	厥	木
橜	厥	木
橝	木	覃
橞	惠	木
機	幾	木
橠	木	袲
橡	木	象
橢	木	隋
橣	木	甯
橤	惢	木
橥	木	猪
橦	木	童
橧	曾	木
橨	木	賁
橩	木	焭
橪	木	然
橫	木	黃
橬	朁	木
橭	木	辜
橮	木	貿
橯	勞	木
橰	木	臯
橱	厨	木
橲	喜	木
橳	勝	木
橴	木	紫
橵	散	木
橶	戟	木
橷	兠	木
橸	晶	木
橹	木	鲁
橺	木	間
橻	丑	木
橼	木	缘
橽	木	達
橾	喿	木
橿	木	畺
檀	亶	木
檁	木	稟
檂	木	農
檃	木	阝	𤔌
檄	敫	木
檅	木	歲
檆	木	煔
檇	木	雋
檈	木	睘
檉	木	聖
檊	幹	木
檋	木	輂
檌	木	罪
檍	意	木
檎	木	禽
檏	木	業
檐	木	詹
檑	木	雷
檒	林	風
檓	木	毁
檔	木	當
檕	木	𣪠
檖	木	遂
檗	木	辟
檘	木	辟
檙	木	鼎
檚	木	楚
檛	木	過
檜	會	木
檝	戢	木
檞	木	解
檟	木	賈
檠	敬	木
檡	木	睪
檢	僉	木
檣	嗇	木
檤	木	道
檥	木	義
檦	剽	木
檧	木	葱
檨	木	羡
檩	木	禀
檪	木	楽
檫	察	木
檬	木	蒙
檭	木	銀
檮	壽	木
檯	木	臺
檰	木	綿
檱	木	箕
檲	團	木
檳	木	賓
檴	木	蒦
檵	㡭	木
檶	奩	木
檷	木	爾
檸	寧	木
檹	旖	木
檺	木	豪
檻	木	監
檼	㥯	木
檽	木	需
檾	林	𤇾
檿	厭	木
櫀	木	綦
櫁	木	蜜
櫂	木	翟
櫃	匱	木
櫄	木	熏
櫅	木	齊
櫆	木	魁
櫇	木	頗
櫈	凳	木
櫉	㕑	木
櫊	木	閣
櫋	木	臱
櫌	憂	木
櫍	木	質
櫎	廣	木
櫏	木	遷
櫐	木	畾
櫑	木	畾
櫒	木	蔡
櫓	木	魯
櫔	厲	木
櫕	木	賛
櫖	慮	木
櫗	木	蔑
櫘	慧	木
櫙	木	蓲
櫚	木	閭
櫛	木	節
櫜	一	中	冖	咎	木
櫝	木	賣
櫞	木	緣
櫟	木	樂
櫠	廢	木
櫡	木	箸
櫢	數	木
櫣	木	莗	辶
櫤	木	箭
櫥	廚	木
櫦	慶	木
櫧	木	諸
櫨	木	盧
櫩	木	閻
櫪	木	歷
櫫	木	豬
櫬	木	親
櫭	暨	木
櫮	噩	木
櫯	木	穌
櫰	木	褱
櫱	木	辥
櫲	木	豫
櫳	木	龍
櫴	木	賴
櫵	木	蕉
櫶	憲	木
櫷	木	龜
櫸	木	舉
櫹	木	蕭
櫺	木	霝
櫻	嬰	木
櫼	木	韱
櫽	木	隱
櫾	木	繇
櫿	木	營
欀	木	襄
欁	木	農
欂	木	薄
欃	木	毚
欄	木	闌
欅	擧	木
欆	木	雙
欇	木	聶
欈	巂	木
欉	叢	木
權	木	雚
欋	木	瞿
欌	木	藏
欍	木	舊
欎	冖	棥	𡬠
欏	木	羅
欐	木	麗
欑	木	贊
欒	䜌	木
欓	木	黨
欔	木	矍
欕	嚴	木
欖	木	覽
欗	木	蘭
欘	屬	木
欙	木	纍
欚	木	蠡
欛	木	霸
欜	囊	木
欝	棥	罒	𡬠
欞	木	靈
欟	木	觀
欠	欠
次	冫	欠
欢	又	欠
欣	斤	欠
欤	与	欠
欥	日	欠
欦	今	欠
欧	区	欠
欨	句	欠
欩	召	欠
欪	出	欠
欫	欠	𦈢
欬	亥	欠
欭	因	欠
欮	屰	欠
欯	吉	欠
欰	欠	血
欱	合	欠
欲	欠	谷
欳	⺊	欠	𠕁
欴	⑤	丶	欠
欵	欠	𠤕
欶	束	欠
欷	希	欠
欸	欠	矣
欹	奇	欠
欺	其	欠
欻	欠	炎
欼	叕	欠
欽	欠	金
款	士	欠	示
欿	欠	臽
歀	柰	欠
歁	欠	甚
歂	欠	耑
歃	欠	臿
歄	咼	欠
歅	垔	欠
歆	欠	音
歇	曷	欠
歈	俞	欠
歉	兼	欠
歊	欠	高
歋	欠	虒
歌	哥	欠
歍	欠	烏
歎	口	夫	廿	欠
歏	堇	欠
歐	區	欠
歑	欠	虖
歒	啇	欠
歓	欠	𮥶
歔	欠	虚
歕	欠	賁
歖	喜	欠
歗	欠	肅
歘	欠	焱
歙	欠	翕
歚	善	欠
歛	僉	欠
歜	欠	蜀
歝	欠	睪
歞	㬎	欠
歟	欠	與
歠	叕	欠	酉
歡	欠	雚
止	止
正	一	止
此	匕	止
步	止	𣥂
武	一	弋	止
歧	支	止
歨	止	龰
歩	少	止
歪	不	正
歫	巨	止
歬	止	舟
歭	寺	止
歮	止	𣥖
歯	凵	止	米
歰	刃	𣥖
歱	止	重
歲	戌	止	𣥂
歳	小	戌	止
歴	止	𠩵
歵	止	責
歶	此	禺
歷	厤	止
歸	帚	止	𠂤
歹	一	夕
歺	⺊	夕
死	匕	歹
歼	千	歹
歽	斤	歹
歾	勿	歹
歿	勹	又	歹
殀	夭	歹
殁	歹	殳
殂	且	歹
殃	央	歹
殄	㐱	歹
殅	歹	生
殆	台	歹
殇	歹	𠂉	𠃓
殈	歹	血
殉	旬	歹
殊	朱	歹
残	戋	歹
殌	巠	歹
殍	孚	歹
殎	夾	歹
殏	歹	求
殐	束	歹
殑	克	歹
殒	员	歹
殓	佥	歹
殔	歹	隶
殕	咅	歹
殖	歹	直
殗	奄	歹
殘	戔	歹
殙	昏	歹
殚	单	歹
殛	亟	歹
殜	枼	歹
殝	歹	秦
殞	員	歹
殟	歹	𥁕
殠	歹	臭
殡	宾	歹
殢	帶	歹
殣	堇	歹
殤	歹	𬀷
殥	寅	歹
殦	歹	鳥
殧	就	歹
殨	歹	貴
殩	歹	𥹏
殪	壹	歹
殫	單	歹
殬	歹	睪
殭	歹	畺
殮	僉	歹
殯	歹	賓
殰	歹	賣
殱	歹	韯
殲	歹	韱
殳	又	𠘧
殴	区	殳
段	⑤	殳
殶	主	殳
殷	㐆	殳
殸	声	殳
殹	医	殳
殺	杀	殳
殻	壳	殳
殼	壳	殳
殽	殳	肴
殾	殳	者
殿	殳	𡱒
毀	土	殳	臼
毁	殳	𬛸
毂	冖	士	殳	车
毃	殳	高
毄	殳	軎
毅	殳	豙
毆	區	殳
毇	䊆	殳
毈	卵	段
毉	巫	殹
毊	喬	殸
毋	毋
毌	毌
母	母
毎	毋	𠂉
每	母	𠂉
毐	士	毋
毑	也	母
毒	母	龶
毓	㐬	每
比	比
毕	十	比
毖	必	比
毗	比	田
毘	比	田
毙	死	比
毚	㲋	兔
毛	丿	乚	二
毜	小	毛
毝	彡	毛
毞	比	毛
毟	少	毛
毠	加	毛
毡	占	毛
毢	毛	西
毣	毛	羽
毤	兊	毛
毥	旬	毛
毦	毛	耳
毧	戎	毛
毨	先	毛
毩	毛	米
毪	毛	牟
毫	亠	冖	口	毛
毬	毛	求
毭	毛	豆
毮	扌	毟
毯	毛	炎
毰	咅	毛
毱	匊	毛
毲	叕	毛
毳	㲎	毛
毴	毛	非
毵	参	毛
毶	参	毛
毷	冒	毛
毸	思	毛
毹	俞	毛
毺	俞	毛
毻	左	月	毛
毼	曷	毛
毽	建	毛
毾	毛	𦐇
毿	參	毛
氀	婁	毛
氁	毛	莫
氂	毛	𠩺
氃	毛	童
氄	毛	矞
氅	敞	毛
氆	普	毛
氇	毛	鲁
氈	亶	毛
氉	喿	毛
氊	亶	毛
氋	毛	蒙
氌	毛	魯
氍	毛	瞿
氎	毛	疉
氏	氏
氐	丶	氏
民	民
氒	十	氏
氓	亡	民
气	一	乁	𠂉
氕	丿	气
氖	乃	气
気	㐅	气
氘	丨	丿	气
氙	山	气
氚	川	气
氛	分	气
氜	日	气
氝	内	气
氞	丙	气
氟	弗	气
氠	气	申
氡	冬	气
氢	气	𢀖
氣	气	米
氤	因	气
氥	气	西
氦	亥	气
氧	气	羊
氨	安	气
氩	亚	气
氪	克	气
氫	巠	气
氬	亞	气
氭	東	气
氮	气	炎
氯	录	气
氰	气	青
氱	昜	气
氲	昷	气
氳	气	𥁕
水	㇇	丿	乀	亅
氵	氵
氶	乛	水
氷	丶	水
永	永
氹	乙	水
氺	丷	亅	八
氻	力	氵
氼	人	水
氽	人	水
氾	㔾	氵
氿	九	氵
汀	丁	氵
汁	十	氵
求	一	丶	氺
汃	八	氵
汄	人	氵
汅	丂	氵
汆	入	水
汇	匚	氵
汈	刁	氵
汉	又	氵
汊	叉	氵
汋	勺	氵
汌	川	氵
汍	丸	氵
汎	凡	氵
汏	大	氵
汐	夕	氵
汑	乇	氵
汒	亡	氵
汓	子	氵
汔	乞	氵
汕	山	氵
汖	山	水
汗	干	氵
汘	千	氵
汙	于	氵
汚	亐	氵
汛	卂	氵
汜	巳	氵
汝	女	氵
汞	工	水
江	工	氵
池	也	氵
污	亏	氵
汢	土	氵
汣	久	氵
汤	氵	𠃓
汥	支	氵
汦	氏	氵
汧	开	氵
汨	日	氵
汩	曰	氵
汪	氵	王
汫	井	氵
汬	井	水
汭	内	氵
汮	匀	氵
汯	厷	氵
汰	太	氵
汱	氵	犬
汲	及	氵
汳	反	氵
汴	卞	氵
汵	今	氵
汶	文	氵
汷	夂	氵
汸	方	氵
汹	凶	氵
決	夬	氵
汻	午	氵
汼	氵	牛
汽	气	氵
汾	分	氵
汿	予	氵
沀	予	水
沁	心	氵
沂	斤	氵
沃	夭	氵
沄	云	氵
沅	元	氵
沆	亢	氵
沇	允	氵
沈	冘	氵
沉	冗	氵
沊	冘	水
沋	尤	氵
沌	屯	氵
沍	互	氵
沎	化	氵
沏	切	氵
沐	木	氵
沑	丑	氵
沒	勹	又	氵
沓	日	水
沔	丏	氵
沕	勿	氵
沖	中	氵
沗	天	氺
沘	比	氵
沙	少	氵
沚	止	氵
沛	巿	氵
沜	氵	片
沝	水
沞	帀	氵
沟	勾	氵
沠	氵	爪
没	殳	氵
沢	尺	氵
沣	丰	氵
沤	区	氵
沥	历	氵
沦	仑	氵
沧	仓	氵
沨	氵	风
沩	为	氵
沪	户	氵
沫	末	氵
沬	未	氵
沭	术	氵
沮	且	氵
沯	水	石
沰	氵	石
沱	它	氵
沲	㐌	氵
河	可	氵
沴	㐱	氵
沵	尔	氵
沶	氵	示
沷	氵	犮
沸	弗	氵
油	氵	由
沺	氵	田
治	台	氵
沼	召	氵
沽	古	氵
沾	占	氵
沿	几	口	氵
泀	司	氵
況	兄	氵
泂	冋	氵
泃	句	氵
泄	世	氵
泅	囚	氵
泆	失	氵
泇	加	氵
泈	冬	氵
泉	水	白
泊	氵	白
泋	卉	氵
泌	必	氵
泍	本	氵
泎	乍	氵
泏	出	氵
泐	氵	阞
泑	幼	氵
泒	氵	瓜
泓	弘	氵
泔	氵	甘
法	去	氵
泖	卯	氵
泗	四	氵
泘	乎	氵
泙	平	氵
泚	此	氵
泛	乏	氵
泜	氐	氵
泝	斥	氵
泞	宁	氵
泟	正	氵
泠	令	氵
泡	包	氵
波	氵	皮
泣	氵	立
泤	以	氵
泥	尼	氵
泦	尻	氵
泧	戉	氵
注	主	氵
泩	氵	生
泪	氵	目
泫	氵	玄
泬	氵	穴
泭	付	氵
泮	半	氵
泯	民	氵
泰	氺	𡗗
泱	央	氵
泲	氵	𠂔
泳	氵	永
泴	水	皿
泵	水	石
泶	冖	水	𭕄
泷	氵	龙
泸	卢	氵
泹	旦	氵
泺	乐	氵
泻	写	氵
泼	发	氵
泽	氵	𠬤
泾	氵	𢀖
泿	氵	艮
洀	氵	舟
洁	吉	氵
洂	亦	氵
洃	氵	灰
洄	回	氵
洅	再	氵
洆	丞	氵
洇	因	氵
洈	危	氵
洉	后	氵
洊	存	氵
洋	氵	羊
洌	列	氵
洍	氵	𦣞
洎	氵	自
洏	氵	而
洐	氵	行
洑	伏	氵
洒	氵	西
洓	朿	氵
洔	寺	氵
洕	䏌	氵
洖	吴	氵
洗	先	氵
洘	氵	考
洙	朱	氵
洚	夅	氵
洛	各	氵
洜	各	水
洝	安	氵
洞	同	氵
洟	夷	氵
洠	氵	牟
洡	氵	耒
洢	伊	氵
洣	氵	米
洤	全	氵
津	氵	聿
洦	氵	百
洧	有	氵
洨	交	氵
洩	曳	氵
洪	共	氵
洫	氵	血
洬	夙	氵
洭	匡	氵
洮	兆	氵
洯	㓞	水
洰	巨	氵
洱	氵	耳
洲	州	氵
洳	如	氵
洴	并	氵
洵	旬	氵
洶	匈	氵
洷	氵	至
洸	光	氵
洹	亘	氵
洺	名	氵
活	氵	舌
洼	圭	氵
洽	合	氵
派	氵	𠂢
洿	夸	氵
浀	曲	氵
流	㐬	氵
浂	关	氵
浃	夹	氵
浄	争	氵
浅	戋	氵
浆	丬	夕	水
浇	尧	氵
浈	氵	贞
浉	师	氵
浊	氵	虫
测	则	氵
浌	伐	氵
浍	会	氵
济	氵	齐
浏	刂	汶
浐	产	氵
浑	军	氵
浒	氵	许
浓	农	氵
浔	寻	氵
浕	尽	氵
浖	寽	氵
浗	氵	求
浘	尾	氵
浙	折	氵
浚	夋	氵
浛	含	氵
浜	兵	氵
浝	尨	氵
浞	氵	足
浟	攸	氵
浠	希	氵
浡	孛	氵
浢	氵	豆
浣	完	氵
浤	宏	氵
浥	氵	邑
浦	氵	甫
浧	呈	氵
浨	宋	氵
浩	告	氵
浪	氵	良
浫	氵	罕
浬	氵	里
浭	更	氵
浮	孚	氵
浯	吾	氵
浰	利	氵
浱	氵	辰
浲	夆	氵
浳	氵	𢎀
浴	氵	谷
浵	彤	氵
浶	氵	牢
海	每	氵
浸	氵	𠬶
浹	夾	氵
浺	忡	氵
浻	冏	氵
浼	免	氵
浽	妥	氵
浾	氵	赤
浿	氵	貝
涀	氵	見
涁	杉	氵
涂	余	氵
涃	困	氵
涄	氵	甹
涅	圼	氵
涆	旰	氵
涇	巠	氵
消	氵	肖
涉	步	氵
涊	忍	氵
涋	宊	氵
涌	氵	甬
涍	孝	氵
涎	延	氵
涏	廷	氵
涐	我	氵
涑	束	氵
涒	君	氵
涓	氵	肙
涔	岑	氵
涕	弟	氵
涖	位	氵
涗	兌	氵
涘	氵	矣
涙	戻	氵
涚	兑	氵
涛	寿	氵
涜	売	氵
涝	劳	氵
涞	来	氵
涟	氵	连
涠	围	氵
涡	呙	氵
涢	员	氵
涣	奂	氵
涤	条	氵
涥	亨	氵
润	氵	闰
涧	氵	间
涨	张	氵
涩	刃	止	氵
涪	咅	氵
涫	官	氵
涬	幸	氵
涭	受	氵
涮	刷	氵
涯	厓	氵
涰	叕	氵
涱	氵	長
液	夜	氵
涳	氵	空
涴	宛	氵
涵	函	氵
涶	垂	氵
涷	東	氵
涸	固	氵
涹	委	氵
涺	居	氵
涻	氵	舍
涼	京	氵
涽	昏	氵
涾	氵	沓
涿	氵	豖
淀	定	氵
淁	妾	氵
淂	㝵	氵
淃	卷	氵
淄	氵	甾
淅	析	氵
淆	氵	肴
淇	其	氵
淈	屈	氵
淉	果	氵
淊	氵	臽
淋	林	氵
淌	尚	氵
淍	周	氵
淎	奉	氵
淏	昊	氵
淐	昌	氵
淑	叔	氵
淒	妻	氵
淓	氵	芳
淔	氵	直
淕	坴	氵
淖	卓	氵
淗	匊	氵
淘	匋	氵
淙	宗	氵
淚	戾	氵
淛	制	氵
淜	朋	氵
淝	氵	肥
淞	松	氵
淟	典	氵
淠	氵	畀
淡	氵	炎
淢	或	氵
淣	兒	氵
淤	於	氵
淥	彔	氵
淦	氵	金
淧	宓	氵
淨	氵	爭
淩	夌	氵
淪	侖	氵
淫	㸒	氵
淬	卒	氵
淭	㦿	氵
淮	氵	隹
淯	氵	育
淰	念	氵
深	氵	罙
淲	氵	虎
淳	享	氵
淴	忽	氵
淵	氵	𣶒
淶	來	氵
混	昆	氵
淸	氵	靑
淹	奄	氵
淺	戔	氵
添	忝	氵
淼	水	沝
淽	氵	芷
淾	水	金
淿	帛	氵
渀	奔	氵
渁	水	氵
渂	旻	氵
渃	氵	若
渄	氵	非
清	氵	青
渆	氵	𠛼
渇	匂	日	氵
済	斉	氵
渉	歩	氵
渊	氵	𫂱
渋	丷	八	止	氵
渌	录	氵
渍	氵	责
渎	卖	氵
渏	奇	氵
渐	斩	氵
渑	氵	黾
渒	卑	氵
渓	夫	氵	爫
渔	氵	鱼
渕	关	刂	氵
渖	审	氵
渗	参	氵
渘	柔	氵
渙	奐	氵
渚	氵	者
減	咸	氵
渜	氵	耎
渝	俞	氵
渞	氵	首
渟	亭	氵
渠	木	洰
渡	度	氵
渢	氵	風
渣	查	氵
渤	勃	氵
渥	屋	氵
渦	咼	氵
渧	帝	氵
渨	氵	畏
温	昷	氵
渪	氵	禹
渫	枼	氵
測	則	氵
渭	氵	胃
渮	氵	苛
港	巷	氵
渰	弇	氵
渱	氵	虹
渲	宣	氵
渳	弭	氵
渴	曷	氵
渵	氵	苗
渶	氵	英
渷	兗	氵
游	斿	氵
渹	氵	訇
渺	氵	眇
渻	氵	省
渼	氵	美
渽	哉	氵
渾	氵	軍
渿	柰	氵
湀	氵	癸
湁	拾	氵
湂	咢	氵
湃	拜	氵
湄	氵	眉
湅	柬	氵
湆	氵	音
湇	氵	𦚏
湈	某	氵
湉	恬	氵
湊	奏	氵
湋	氵	韋
湌	氵	食
湍	氵	耑
湎	氵	面
湏	氵	頁
湐	柏	氵
湑	氵	胥
湒	咠	氵
湓	氵	盆
湔	前	氵
湕	建	氵
湖	氵	胡
湗	封	氵
湘	氵	相
湙	奕	氵
湚	氵	胤
湛	氵	甚
湜	是	氵
湝	氵	皆
湞	氵	貞
湟	氵	皇
湠	氵	炭
湡	氵	禺
湢	氵	畐
湣	昬	氵
湤	施	氵
湥	氵	突
湦	星	氵
湧	勇	氵
湨	氵	狊
湩	氵	重
湪	彖	氵
湫	氵	秋
湬	水	秋
湭	氵	酋
湮	垔	氵
湯	昜	氵
湰	㚅	氵
湱	氵	砉
湲	氵	爰
湳	南	氵
湴	並	氵
湵	氵	羑
湶	氵	泉
湷	春	氵
湸	亮	氵
湹	厘	氵
湺	保	氵
湻	亯	氵
湼	氵	𬛸
湽	氵	甾
湾	弯	氵
湿	显	氵
満	両	氵	艹
溁	氵	荣
溂	剌	氵
溃	氵	贵
溄	山	氵	𡕖
溅	氵	贱
溆	叙	氵
溇	娄	氵
溈	氵	為
溉	既	氵
溊	叚	氵
溋	氵	盈
溌	氵	発
溍	晋	氵
溎	桂	氵
溏	唐	氵
源	原	氵
溑	氵	𧴪
溒	氵	袁
溓	兼	氵
溔	氵	羔
溕	冡	氵
準	十	淮
溗	乘	氵
溘	氵	盍
溙	氵	泰
溚	氵	荅
溛	氵	窊
溜	氵	留
溝	冓	氵
溞	氵	蚤
溟	冥	氵
溠	差	氵
溡	時	氵
溢	氵	益
溣	倫	氵
溤	氵	馬
溥	尃	氵
溦	氵	𢼸
溧	栗	氵
溨	栽	氵
溩	氵	烏
溪	奚	氵
溫	氵	𥁕
溬	氵	羗
溭	氵	畟
溮	師	氵
溯	朔	氵
溰	氵	豈
溱	氵	秦
溲	叟	氵
溳	員	氵
溴	氵	臭
溵	殷	氵
溶	容	氵
溷	圂	氵
溸	氵	素
溹	氵	索
溺	弱	氵
溻	氵	𦐇
溼	氵	𡌥
溽	氵	辱
溾	氵	鬼
溿	氵	畔
滀	氵	畜
滁	氵	除
滂	旁	氵
滃	氵	翁
滄	倉	氵
滅	氵	烕
滆	氵	鬲
滇	氵	真
滈	氵	高
滉	晃	氵
滊	氣	氵
滋	兹	氵
滌	條	氵
滍	氵	蚩
滎	水	𤇾
滏	氵	釜
滐	桀	氵
滑	氵	骨
滒	哥	氵
滓	宰	氵
滔	氵	舀
滕	月	𣳾
滖	氵	衰
滗	氵	笔
滘	㓁	氵	𢀛
滙	氵	龨
滚	氵	衮
滛	䍃	氵
滜	氵	皋
滝	氵	竜
滞	带	氵
滟	氵	艳
滠	氵	聂
满	氵	𬜯
滢	氵	莹
滣	唇	氵
滤	氵	虑
滥	氵	监
滦	栾	氵
滧	效	氵
滨	宾	氵
滩	氵	难
滪	氵	预
滫	氵	脩
滬	扈	氵
滭	氵	畢
滮	彪	氵
滯	帶	氵
滰	氵	竟
滱	寇	氵
滲	參	氵
滳	商	氵
滴	啇	氵
滵	密	氵
滶	敖	氵
滷	氵	鹵
滸	氵	許
滹	氵	虖
滺	悠	氵
滻	氵	産
滼	梵	氵
滽	庸	氵
滾	氵	袞
滿	㒼	氵
漀	殸	水
漁	氵	魚
漂	氵	票
漃	寂	氵
漄	崖	氵
漅	巢	氵
漆	桼	氵
漇	徙	氵
漈	氵	祭
漉	氵	鹿
漊	婁	氵
漋	氵	隆
漌	堇	氵
漍	國	氵
漎	從	氵
漏	屚	氵
漐	執	水
漑	旣	氵
漒	强	氵
漓	氵	离
演	寅	氵
漕	曹	氵
漖	教	氵
漗	悤	氵
漘	氵	脣
漙	專	氵
漚	區	氵
漛	氵	𣳾
漜	埜	氵
漝	氵	習
漞	氵	覓
漟	堂	氵
漠	氵	莫
漡	氵	𬀷
漢	口	夫	廿	氵
漣	氵	連
漤	婪	氵
漥	氵	窐
漦	水	𠩺
漧	乾	氵
漨	氵	逢
漩	旋	氵
漪	氵	猗
漫	曼	氵
漬	氵	責
漭	氵	莽
漮	康	氵
漯	氵	累
漰	崩	氵
漱	欶	氵
漲	張	氵
漳	氵	章
漴	崇	氵
漵	敘	氵
漶	患	氵
漷	氵	郭
漸	斬	氵
漹	氵	焉
漺	氵	爽
漻	氵	翏
漼	崔	氵
漽	氵	犀
漾	氵	羕
漿	將	水
潀	氵	眾
潁	匕	水	頁
潂	並	山	氵
潃	彳	攵	月	氵
潄	敕	氵
潅	氵	𮥶
潆	氵	萦
潇	氵	萧
潈	氵	𬑔
潉	崑	氵
潊	敍	氵
潋	敛	氵
潌	氵	窒
潍	氵	维
潎	敝	氵
潏	氵	矞
潐	氵	焦
潑	氵	發
潒	氵	象
潓	惠	氵
潔	氵	絜
潕	氵	無
潖	氵	琶
潗	氵	集
潘	氵	番
潙	氵	爲
潚	氵	肅
潛	朁	氵
潜	替	氵
潝	氵	翕
潞	氵	路
潟	氵	舄
潠	巽	氵
潡	敦	氵
潢	氵	黄
潣	氵	閔
潤	氵	閏
潥	氵	粟
潦	尞	氵
潧	曾	氵
潨	氵	衆
潩	氵	異
潪	智	氵
潫	氵	絭
潬	單	氵
潭	氵	覃
潮	朝	氵
潯	尋	氵
潰	氵	貴
潱	壹	氵
潲	氵	稍
潳	屠	氵
潴	氵	猪
潵	散	氵
潶	氵	黑
潷	氵	筆
潸	月	林	氵
潹	森	氵
潺	孱	氵
潻	氵	黍
潼	氵	童
潽	普	氵
潾	氵	粦
潿	圍	氵
澀	歰	氵
澁	歮	氵
澂	氵	𢽠
澃	水	須
澄	氵	登
澅	氵	畫
澆	堯	氵
澇	勞	氵
澈	攵	氵	育
澉	敢	氵
澊	尊	氵
澋	景	氵
澌	斯	氵
澍	尌	氵
澎	彭	氵
澏	嵒	氵
澐	氵	雲
澑	氵	畱
澒	氵	項
澓	復	氵
澔	氵	皓
澕	氵	華
澖	氵	閑
澗	氵	間
澘	氵	𣈅
澙	氵	舃
澚	丂	丿	冂	氵	米
澛	氵	鲁
澜	氵	阑
澝	氵	甯
澞	氵	虞
澟	氵	稟
澠	氵	黽
澡	喿	氵
澢	氵	當
澣	幹	氵
澤	氵	睪
澥	氵	解
澦	氵	預
澧	氵	豊
澨	氵	筮
澩	水	𦥯
澪	氵	零
澫	氵	萬
澬	氵	資
澭	氵	雍
澮	會	氵
澯	氵	粲
澰	僉	氵
澱	殿	氵
澲	業	氵
澳	奥	氵
澴	氵	睘
澵	新	氵
澶	亶	氵
澷	㬅	氵
澸	感	氵
澹	氵	詹
澺	意	氵
澻	氵	遂
澼	氵	辟
澽	氵	豦
澾	氵	達
澿	氵	禁
激	敫	氵
濁	氵	蜀
濂	廉	氵
濃	氵	農
濄	氵	過
濅	氵	𡩠
濆	氵	賁
濇	嗇	氵
濈	戢	氵
濉	氵	睢
濊	歲	氵
濋	楚	氵
濌	沓	重
濍	氵	葱
濎	氵	鼎
濏	氵	瑟
濐	暑	氵
濑	氵	赖
濒	氵	频
濓	亷	氵
濔	氵	爾
濕	㬎	氵
濖	氵	署
濗	幕	氵
濘	寧	氵
濙	氵	熒
濚	榮	氵
濛	氵	蒙
濜	氵	盡
濝	氵	綦
濞	氵	鼻
濟	氵	齊
濠	氵	豪
濡	氵	需
濢	氵	翠
濣	斡	氵
濤	壽	氵
濥	夤	氵
濦	㥯	氵
濧	對	氵
濨	慈	氵
濩	氵	蒦
濪	氵	靘
濫	氵	監
濬	氵	睿
濭	氵	蓋
濮	僕	氵
濯	氵	翟
濰	氵	維
濱	氵	賓
濲	氵	穀
濳	㬱	氵
濴	氵	滎
濵	氵	賔
濶	䦚	氵
濷	水	滿
濸	氵	蒼
濹	墨	氵
濺	氵	賤
濻	氵	隤
濼	樂	氵
濽	氵	賛
濾	慮	氵
濿	厲	氵
瀀	憂	氵
瀁	氵	養
瀂	氵	魯
瀃	氵	賜
瀄	氵	節
瀅	氵	瑩
瀆	氵	賣
瀇	廣	氵
瀈	氵	翬
瀉	寫	氵
瀊	氵	盤
瀋	審	氵
瀌	氵	麃
瀍	廛	氵
瀎	氵	蔑
瀏	劉	氵
瀐	氵	韯
瀑	暴	氵
瀒	氵	𠾂
瀓	徵	氵
瀔	氵	穀
瀕	氵	頻
瀖	氵	霍
瀗	憲	氵
瀘	氵	盧
瀙	氵	親
瀚	氵	翰
瀛	嬴	氵
瀜	氵	融
瀝	歷	氵
瀞	氵	静
瀟	氵	蕭
瀠	氵	縈
瀡	氵	隨
瀢	氵	遺
瀣	氵	韰
瀤	氵	褱
瀥	氵	翯
瀦	氵	豬
瀧	氵	龍
瀨	氵	賴
瀩	氵	頽
瀪	敏	泉
瀫	氵	縠
瀬	氵	頼
瀭	氵	輸
瀮	氵	霖
瀯	氵	營
瀰	彌	氵
瀱	氵	罽
瀲	斂	氵
瀳	氵	薦
瀴	嬰	氵
瀵	氵	糞
瀶	氵	臨
瀷	氵	翼
瀸	氵	韱
瀹	氵	龠
瀺	毚	氵
瀻	戴	氵
瀼	氵	襄
瀽	氵	蹇
瀾	氵	闌
瀿	氵	繁
灀	氵	霜
灁	氵	闎
灂	氵	爵
灃	氵	豐
灄	氵	聶
灅	壘	氵
灆	氵	藍
灇	叢	氵
灈	氵	瞿
灉	氵	雝
灊	氵	鬵
灋	去	廌	氵
灌	氵	雚
灍	氵	闕
灎	澧	盍
灏	澋	页
灐	氵	鎣
灑	氵	麗
灒	氵	贊
灓	䜌	水
灔	氵	艶
灕	氵	離
灖	氵	靡
灗	氵	蟺
灘	氵	難
灙	氵	黨
灚	氵	覺
灛	氵	闡
灜	氵	贏
灝	氵	顥
灞	氵	霸
灟	屬	氵
灠	氵	覽
灡	氵	蘭
灢	囊	氵
灣	彎	氵
灤	欒	氵
灥	泉
灦	氵	顯
灧	氵	艷
灨	氵	贛
灩	氵	豔
灪	氵	鬱
火	人	八
灬	灬
灭	一	火
灮	儿	火
灯	丁	火
灰	火	𠂇
灱	刀	火
灲	刂	火
灳	勹	火
灴	工	火
灵	彐	火
灶	土	火
灷	廾	火
灸	久	火
灹	乇	火
灺	也	火
灻	土	火
灼	勺	火
災	巛	火
灾	宀	火
灿	山	火
炀	火	𠃓
炁	旡	灬
炂	公	火
炃	分	火
炄	丑	火
炅	日	火
炆	文	火
炇	攵	火
炈	殳	火
炉	户	火
炊	欠	火
炋	不	火
炌	介	火
炍	反	火
炎	火
炏	火
炐	丰	火
炑	木	火
炒	少	火
炓	斗	火
炔	夬	火
炕	亢	火
炖	屯	火
炗	廿	火
炘	斤	火
炙	⺀	火	𠂊
炚	日	火
炛	化	火
炜	火	韦
炝	仓	火
炞	卞	火
炟	旦	火
炠	火	甲
炡	正	火
炢	术	火
炣	可	火
炤	召	火
炥	弗	火
炦	火	犮
炧	㐌	火
炨	它	火
炩	令	火
炪	出	火
炫	火	玄
炬	巨	火
炭	山	灰
炮	包	火
炯	冋	火
炰	包	灬
炱	台	火
炲	台	火
炳	丙	火
炴	央	火
炵	冬	火
炶	占	火
炷	主	火
炸	乍	火
点	占	灬
為	為
炻	火	石
炼	火	𫠣
炽	只	火
炾	兄	火
炿	丶	火	𠔾
烀	乎	火
烁	乐	火
烂	兰	火
烃	火	𢀖
烄	交	火
烅	火	血
烆	火	行
烇	全	火
烈	列	灬
烉	火	𠂊	𠔿
烊	火	羊
烋	休	灬
烌	休	火
烍	先	火
烎	开	火
烏	⑥	灬
烐	火	舟
烑	兆	火
烒	式	火
烓	圭	火
烔	同	火
烕	戌	火
烖	火	𢦏
烗	亥	火
烘	共	火
烙	各	火
烚	合	火
烛	火	虫
烜	亘	火
烝	丞	灬
烞	朴	火
烟	因	火
烠	有	火
烡	共	火
烢	宅	火
烣	火	灰
烤	火	考
烥	火	臣
烦	火	页
烧	尧	火
烨	华	火
烩	会	火
烪	关	火
烫	汤	火
烬	尽	火
热	执	灬
烮	列	火
烯	希	火
烰	孚	火
烱	冏	火
烲	折	火
烳	火	甫
烴	巠	火
烵	火	芍
烶	廷	火
烷	完	火
烸	每	火
烹	亨	灬
烺	火	良
烻	延	火
烼	火	豕
烽	夆	火
烾	土	炎
烿	彤	火
焀	火	谷
焁	吹	火
焂	攸	火
焃	火	赤
焄	君	灬
焅	告	火
焆	火	肙
焇	火	肖
焈	戺	火
焉	②	正	灬
焊	旱	火
焋	壯	火
焌	夋	火
焍	弟	火
焎	折	灬
焏	了	叹	灬
焐	吾	火
焑	困	火
焒	吕	火
焓	含	火
焔	旧	火	𠂊
焕	奂	火
焖	火	闷
焗	局	火
焘	寿	灬
焙	咅	火
焚	林	火
焛	火	門
焜	昆	火
焝	昏	火
焞	享	火
焟	昔	火
焠	卒	火
無	一	卌	灬	𠂉
焢	火	空
焣	取	灬
焤	府	火
焥	宛	火
焦	灬	隹
焧	忩	火
焨	冐	火
焩	朋	火
焪	火	穹
焫	火	芮
焬	易	火
焭	几	𤇾
焮	欣	火
焯	卓	火
焰	火	臽
焱	火	炏
焲	夜	火
焳	火	隹
焴	火	育
焵	岡	火
然	冫	灬	犬	𠂊
焷	卑	火
焸	昍	火
焹	火	罔
焺	昇	火
焻	昌	火
焼	尭	火
焽	明	火
焾	念	火
焿	庚	火
煀	屈	火
煁	火	甚
煂	火	革
煃	奎	火
煄	火	重
煅	段	火
煆	叚	火
煇	火	軍
煈	火	風
煉	柬	火
煊	宣	火
煋	星	火
煌	火	皇
煍	火	秋
煎	前	灬
煏	火	畐
煐	火	英
煑	火	者
煒	火	韋
煓	火	耑
煔	占	炎
煕	巸	灬
煖	火	爰
煗	火	耎
煘	咸	火
煙	垔	火
煚	昛	火
煛	䀠	火
煜	昱	火
煝	火	眉
煞	灬	𭣦
煟	火	胃
煠	枼	火
煡	建	火
煢	卂	𤇾
煣	柔	火
煤	某	火
煥	奐	火
煦	昫	灬
照	昭	灬
煨	火	畏
煩	火	頁
煪	火	酋
煫	㒸	火
煬	昜	火
煭	刂	灬	𣧄
煮	灬	者
煯	火	皆
煰	品	火
煱	咼	火
煲	保	火
煳	火	胡
煴	昷	火
煵	南	火
煶	是	火
煷	亮	火
煸	扁	火
煹	冓	火
煺	火	退
煻	唐	火
煼	火	芻
煽	扇	火
煾	恩	火
煿	尃	火
熀	晃	火
熁	火	脅
熂	氣	火
熃	務	火
熄	息	火
熅	火	𥁕
熆	火	盍
熇	火	高
熈	㇓	巳	灬	臣
熉	員	火
熊	灬	能
熋	火	能
熌	火	閃
熍	宮	火
熎	䍃	火
熏	熏
熐	冥	火
熑	兼	火
熒	火	𤇾
熓	火	烏
熔	容	火
熕	火	貢
熖	火	舀
熗	倉	火
熘	火	留
熙	巸	灬
熚	火	畢
熛	火	票
熜	悤	火
熝	火	鹿
熞	堅	火
熟	孰	灬
熠	火	習
熡	婁	火
熢	火	逢
熣	崔	火
熤	火	翌
熥	火	通
熦	火	雀
熧	從	火
熨	尉	火
熩	扈	火
熪	火	移
熫	庶	火
熬	敖	灬
熭	彗	火
熮	火	翏
熯	口	夫	廿	火
熰	區	火
熱	埶	灬
熲	頁	𭴁
熳	曼	火
熴	崑	火
熵	商	火
熶	最	火
熷	曾	火
熸	朁	火
熹	喜	灬
熺	喜	火
熻	火	翕
熼	火	異
熽	火	肅
熾	戠	火
熿	火	黄
燀	單	火
燁	火	華
燂	火	覃
燃	火	然
燄	炎	臽
燅	坴	炎
燆	喬	火
燇	尊	火
燈	火	登
燉	敦	火
燊	木	焱
燋	火	焦
燌	火	賁
燍	斯	火
燎	尞	火
燏	火	矞
燐	火	粦
燑	火	童
燒	堯	火
燓	棥	火
燔	火	番
燕	北	口	廿	灬
燖	尋	火
燗	火	閒
燘	火	閔
燙	湯	火
燚	炏
燛	火	臦
燜	悶	火
燝	景	火
燞	欠	灬	隹
營	呂	𤇾
燠	奥	火
燡	火	睪
燢	火	𦥯
燣	火	稟
燤	火	萬
燥	喿	火
燦	火	粲
燧	火	遂
燨	火	義
燩	敫	火
燪	火	葱
燫	廉	火
燬	毁	火
燭	火	蜀
燮	又	火	言
燯	火	零
燰	愛	火
燱	意	火
燲	䝱	火
燳	火	照
燴	會	火
燵	火	達
燶	火	農
燷	火	禀
燸	火	需
燹	火	豩
燺	槀	火
燻	火	熏
燼	火	盡
燽	壽	火
燾	壽	灬
燿	火	翟
爀	火	赫
爁	火	監
爂	冖	同	火	𦥑
爃	榮	火
爄	厲	火
爅	墨	火
爆	暴	火
爇	熱	艹
爈	慮	火
爉	巤	火
爊	火	麃
爋	勳	火
爌	廣	火
爍	樂	火
爎	寮	火
爏	歷	火
爐	火	盧
爑	火	蕉
爒	尞	炙
爓	火	閻
爔	火	羲
爕	火	言
爖	火	龍
爗	曅	火
爘	火	餐
爙	火	襄
爚	火	龠
爛	火	闌
爜	叢	火
爝	火	爵
爞	火	蟲
爟	火	雚
爠	火	瞿
爡	火	蠆
爢	灬	靡
爣	火	黨
爤	火	蘭
爥	屬	火
爦	火	覽
爧	火	靈
爨	冖	同	𤍾	𦥑
爩	火	鬱
爪	爪
爫	丿	𭕄
爬	巴	爪
爭	コ	一	亅	爫
爮	包	爪
爯	冉	爫
爰	一	友	爫
爱	冖	友	爫
爲	爲
爳	了	爲
爴	國	爪
爵	爫	罒	𡬠
父	乂	八
爷	卩	父
爸	巴	父
爹	多	父
爺	父	耶
爻	㐅	乂
爼	且	爻
爽	㸚	大
爾	㸚	一	八	巾
爿	爿
牀	木	爿
牁	可	爿
牂	爿	羊
牃	枼	爿
牄	倉	爿
牅	庸	爿
牆	嗇	爿
片	片
版	反	片
牉	半	片
牊	召	片
牋	戔	片
牌	卑	片
牍	卖	片
牎	怱	片
牏	俞	片
牐	片	臿
牑	扁	片
牒	枼	片
牓	旁	片
牔	尃	片
牕	悤	片
牖	户	片	甫
牗	庸	片
牘	片	賣
牙	牙
牚	牙	𫩠
牛	牛
牜	牜
牝	匕	牛
牞	力	牛
牟	厶	牛
牠	也	牛
牡	土	牛
牢	宀	牛
牣	刃	牛
牤	亡	牛
牥	方	牛
牦	毛	牛
牧	攵	牛
牨	亢	牛
物	勿	牛
牪	牛
牫	戈	牛
牬	牛	𠂔
牭	四	牛
牮	代	牛
牯	古	牛
牰	牛	由
牱	可	牛
牲	牛	生
牳	母	牛
牴	氐	牛
牵	冖	大	牛
牶	牛	龹
牷	全	牛
牸	字	牛
特	寺	牛
牺	牛	西
牻	尨	牛
牼	巠	牛
牽	亠	冖	幺	牛
牾	吾	牛
牿	告	牛
犀	丨	丷	八	尸	牛
犁	利	牛
犂	牛	𥝢
犃	咅	牛
犄	奇	牛
犅	岡	牛
犆	牛	直
犇	牛	牪
犈	卷	牛
犉	享	牛
犊	卖	牛
犋	具	牛
犌	叚	牛
犍	建	牛
犎	封	牛
犏	扁	牛
犐	牛	科
犑	牛	狊
犒	牛	高
犓	牛	芻
犔	氣	牛
犕	牛	𤰇
犖	牛	𤇾
犗	害	牛
犘	牛	麻
犙	參	牛
犚	尉	牛
犛	牛	𠩺
犜	敦	牛
犝	牛	童
犞	喬	牛
犟	强	牛
犠	牛	義
犡	厲	牛
犢	牛	賣
犣	巤	牛
犤	牛	罷
犥	牛	麃
犦	暴	牛
犧	牛	羲
犨	牛	雔
犩	牛	魏
犪	夔	牛
犫	牛	讎
犬	犬
犭	犭
犮	丶	友
犯	㔾	犭
犰	九	犭
犱	丸	犭
犲	才	犭
犳	勺	犭
犴	干	犭
犵	乞	犭
状	丬	犬
犷	广	犭
犸	犭	马
犹	尤	犭
犺	亢	犭
犻	巿	犭
犼	孔	犭
犽	牙	犭
犾	犬	犭
犿	卞	犭
狀	爿	犬
狁	允	犭
狂	犭	王
狃	丑	犭
狄	火	犭
狅	壬	犭
狆	中	犭
狇	木	犭
狈	犭	贝
狉	丕	犭
狊	犬	目
狋	犭	示
狌	犭	生
狍	包	犭
狎	犭	甲
狏	㐌	犭
狐	犭	瓜
狑	令	犭
狒	弗	犭
狓	犭	皮
狔	尼	犭
狕	幼	犭
狖	犭	穴
狗	句	犭
狘	戉	犭
狙	且	犭
狚	旦	犭
狛	犭	白
狜	古	犭
狝	尔	犭
狞	宁	犭
狟	亘	犭
狠	犭	艮
狡	交	犭
狢	各	犭
狣	兆	犭
狤	吉	犭
狥	旬	犭
狦	犭	𠕋
狧	犭	舌
狨	戎	犭
狩	守	犭
狪	同	犭
狫	犭	老
独	犭	虫
狭	夹	犭
狮	师	犭
狯	会	犭
狰	争	犭
狱	犬	犭	讠
狲	孙	犭
狳	余	犭
狴	坒	犭
狵	尨	犭
狶	希	犭
狷	犭	肙
狸	犭	里
狹	夾	犭
狺	犭	言
狻	夋	犭
狼	犭	良
狽	犭	貝
狾	折	犭
狿	延	犭
猀	沙	犭
猁	利	犭
猂	旱	犭
猃	佥	犭
猄	京	犭
猅	犭	非
猆	犬	非
猇	犭	虎
猈	卑	犭
猉	其	犭
猊	兒	犭
猋	㹜	犬
猌	來	犬
猍	來	犭
猎	昔	犭
猏	犭	肩
猐	犭	羌
猑	昆	犭
猒	冐	犬
猓	果	犭
猔	宗	犭
猕	弥	犭
猖	昌	犭
猗	奇	犭
猘	制	犭
猙	爭	犭
猚	犭	隹
猛	孟	犭
猜	犭	青
猝	卒	犭
猞	犭	舍
猟	犭	鼡
猠	典	犭
猡	犭	罗
猢	犭	胡
猣	㚇	犭
猤	犭	癸
猥	犭	畏
猦	犭	風
猧	咼	犭
猨	爰	犭
猩	星	犭
猪	犭	者
猫	犭	苗
猬	犭	胃
猭	彖	犭
献	南	犬
猯	犭	耑
猰	契	犭
猱	柔	犭
猲	曷	犭
猳	叚	犭
猴	侯	犭
猵	扁	犭
猶	犭	酋
猷	犬	酋
猸	犭	眉
猹	查	犭
猺	䍃	犭
猻	孫	犭
猼	尃	犭
猽	冥	犭
猾	犭	骨
猿	犭	袁
獀	叟	犭
獁	犭	馬
獂	原	犭
獃	犬	豈
獄	犬	犭	言
獅	師	犭
獆	犭	皋
獇	犭	羗
獈	犭	益
獉	犭	秦
獊	倉	犭
獋	犭	臯
獌	曼	犭
獍	犭	竟
獎	將	犬
獏	犭	莫
獐	犭	章
獑	斬	犭
獒	敖	犬
獓	敖	犭
獔	犭	皐
獕	崔	犭
獖	犭	賁
獗	厥	犭
獘	敝	犬
獙	敝	犭
獚	犭	黄
獛	犭	菐
獜	犭	粦
獝	犭	矞
獞	犭	童
獟	堯	犭
獠	尞	犭
獡	犭	舄
獢	喬	犭
獣	一	口	犬	畄
獤	敦	犭
獥	敫	犭
獦	犭	葛
獧	犭	睘
獨	犭	蜀
獩	歲	犭
獪	會	犭
獫	僉	犭
獬	犭	解
獭	犭	赖
獮	爾	犭
獯	熏	犭
獰	寧	犭
獱	犭	賓
獲	犭	蒦
獳	犭	需
獴	犭	蒙
獵	巤	犭
獶	憂	犭
獷	廣	犭
獸	嘼	犬
獹	犭	盧
獺	犭	賴
獻	犬	鬳
獼	彌	犭
獽	犭	襄
獾	犭	雚
獿	夒	犭
玀	犭	羅
玁	嚴	犭
玂	犭	蘄
玃	犭	矍
玄	亠	幺
玅	少	玄
玆	玄
率	丷	八	十	玄
玈	④	玄	𠂉
玉	丶	王
玊	丶	王
王	一	土
玌	乚	王
玍	丿	王
玎	丁	王
玏	力	王
玐	八	王
玑	几	王
玒	工	王
玓	勺	王
玔	川	王
玕	干	王
玖	久	王
玗	于	王
玘	己	王
玙	与	王
玚	王	𠃓
玛	王	马
玜	公	王
玝	午	王
玞	夫	王
玟	文	王
玠	介	王
玡	牙	王
玢	分	王
玣	卞	王
玤	丰	王
玥	月	王
玦	夬	王
玧	允	王
玨	王
玩	元	王
玪	今	王
玫	攵	王
玬	丹	王
玭	比	王
玮	王	韦
环	不	王
现	王	见
玱	仓	王
玲	令	王
玳	代	王
玴	世	王
玵	王	甘
玶	平	王
玷	占	王
玸	包	王
玹	玄	王
玺	尔	玉
玻	王	皮
玼	此	王
玽	句	王
玾	王	甲
玿	召	王
珀	王	白
珁	王	瓦
珂	可	王
珃	冉	王
珄	王	生
珅	王	申
珆	台	王
珇	且	王
珈	加	王
珉	民	王
珊	册	王
珋	卯	王
珌	必	王
珍	㐱	王
珎	尔	王
珏	玉	王
珐	去	王
珑	王	龙
珒	王	聿
珓	交	王
珔	存	王
珕	劦	王
珖	光	王
珗	先	王
珘	王	舟
珙	共	王
珚	因	王
珛	有	王
珜	王	羊
珝	王	羽
珞	各	王
珟	夙	王
珠	朱	王
珡	人	玨
珢	王	艮
珣	旬	王
珤	王	缶
珥	王	耳
珦	向	王
珧	兆	王
珨	合	王
珩	王	行
珪	圭	王
珫	充	王
珬	戌	王
班	②	王
珮	王	𫥞
珯	王	老
珰	当	王
珱	女	王	𭕄
珲	军	王
珳	彣	王
珴	我	王
珵	呈	王
珶	弟	王
珷	武	王
珸	吾	王
珹	成	王
珺	君	王
珻	每	王
珼	王	貝
珽	廷	王
現	王	見
珿	王	足
琀	含	王
琁	王	𭻾
琂	王	言
球	求	王
琄	王	肙
琅	王	良
理	王	里
琇	王	秀
琈	孚	王
琉	㐬	王
琊	王	邪
琋	希	王
琌	岑	王
琍	利	王
琎	王	进
琏	王	连
琐	王	𭕆
琑	王	肖
琒	夆	王
琓	完	王
琔	定	王
琕	卑	王
琖	戔	王
琗	卒	王
琘	昏	王
琙	或	王
琚	居	王
琛	王	罙
琜	來	王
琝	旻	王
琞	明	玉
琟	王	隹
琠	典	王
琡	叔	王
琢	王	豖
琣	咅	王
琤	争	王
琥	王	虎
琦	奇	王
琧	亞	玉
琨	昆	王
琩	昌	王
琪	其	王
琫	奉	王
琬	宛	王
琭	录	王
琮	宗	王
琯	官	王
琰	炎	王
琱	周	王
琲	王	非
琳	林	王
琴	今	玨
琵	比	玨
琶	巴	玨
琷	王	羌
琸	卓	王
琹	木	玨
琺	法	王
琻	王	金
琼	京	王
琽	王	者
琾	王	界
琿	王	軍
瑀	王	禹
瑁	冒	王
瑂	王	眉
瑃	春	王
瑄	宣	王
瑅	是	王
瑆	星	王
瑇	毒	王
瑈	柔	王
瑉	昬	王
瑊	咸	王
瑋	王	韋
瑌	王	耎
瑍	奐	王
瑎	王	皆
瑏	王	穿
瑐	前	王
瑑	彖	王
瑒	昜	王
瑓	柬	王
瑔	泉	王
瑕	叚	王
瑖	段	王
瑗	爰	王
瑘	王	耶
瑙	王	𡿺
瑚	王	胡
瑛	王	英
瑜	俞	王
瑝	王	皇
瑞	王	耑
瑟	必	玨
瑠	王	留
瑡	師	王
瑢	容	王
瑣	王	𧴪
瑤	䍃	王
瑥	昷	王
瑦	烏	王
瑧	王	秦
瑨	晋	王
瑩	玉	𤇾
瑪	王	馬
瑫	王	舀
瑬	流	玉
瑭	唐	王
瑮	栗	王
瑯	王	郎
瑰	王	鬼
瑱	王	真
瑲	倉	王
瑳	差	王
瑴	一	冖	士	殳	王
瑵	王	蚤
瑶	䍃	王
瑷	爱	王
瑸	宾	王
瑹	王	荼
瑺	常	王
瑻	王	貫
瑼	專	王
瑽	從	王
瑾	堇	王
瑿	殹	玉
璀	崔	王
璁	悤	王
璂	基	王
璃	王	离
璄	王	竟
璅	巢	王
璆	王	翏
璇	旋	王
璈	敖	王
璉	王	連
璊	㒼	王
璋	王	章
璌	寅	王
璍	王	華
璎	婴	王
璏	彘	王
璐	王	路
璑	無	王
璒	王	登
璓	王	莠
璔	曾	王
璕	尋	王
璖	渠	王
璗	湯	玉
璘	王	粦
璙	尞	王
璚	王	矞
璛	王	肅
璜	王	黄
璝	王	貴
璞	王	菐
璟	景	王
璠	王	番
璡	王	進
璢	王	畱
璣	幾	王
璤	惠	王
璥	敬	王
璦	愛	王
璧	玉	辟
璨	王	粲
璩	王	豦
璪	喿	王
璫	王	當
璬	敫	王
璭	王	運
璮	亶	王
璯	會	王
環	王	睘
璱	王	瑟
璲	王	遂
璳	朱	王	貝
璴	楚	王
璵	王	與
璶	王	盡
璷	敷	王
璸	王	賓
璹	壽	王
璺	冖	同	玉	𦥑
璻	王	翠
璼	王	監
璽	爾	玉
璾	王	齊
璿	王	睿
瓀	王	需
瓁	王	蒦
瓂	王	蓋
瓃	王	畾
瓄	王	賣
瓅	樂	王
瓆	王	質
瓇	憂	王
瓈	王	黎
瓉	王	賛
瓊	夐	王
瓋	王	適
瓌	王	褱
瓍	王	隨
瓎	王	賴
瓏	王	龍
瓐	王	盧
瓑	歷	王
瓒	王	赞
瓓	王	闌
瓔	嬰	王
瓕	彌	玉
瓖	王	襄
瓗	巂	王
瓘	王	雚
瓙	燾	王
瓚	王	贊
瓛	獻	王
瓜	瓜
瓝	勺	瓜
瓞	失	瓜
瓟	包	瓜
瓠	夸	瓜
瓡	幸	瓜
瓢	瓜	票
瓣	瓜	辛
瓤	瓜	襄
瓥	䖵	瓜	豕
瓦	瓦
瓧	十	瓦
瓨	工	瓦
瓩	千	瓦
瓪	反	瓦
瓫	分	瓦
瓬	方	瓦
瓭	冘	瓦
瓮	公	瓦
瓯	区	瓦
瓰	分	瓦
瓱	毛	瓦
瓲	屯	瓦
瓳	古	瓦
瓴	令	瓦
瓵	台	瓦
瓶	并	瓦
瓷	次	瓦
瓸	瓦	百
瓹	瓦	肙
瓺	瓦	镸
瓻	希	瓦
瓼	瓦	里
瓽	瓦	𫩠
瓾	委	瓦
瓿	咅	瓦
甀	垂	瓦
甁	幷	瓦
甂	扁	瓦
甃	瓦	秋
甄	垔	瓦
甅	厘	瓦
甆	兹	瓦
甇	瓦	𤇾
甈	瓦	臬
甉	兼	瓦
甊	婁	瓦
甋	啇	瓦
甌	區	瓦
甍	冖	瓦	罒	艹
甎	專	瓦
甏	彭	瓦
甐	瓦	粦
甑	曾	瓦
甒	無	瓦
甓	瓦	辟
甔	瓦	詹
甕	瓦	雍
甖	瓦	賏
甗	瓦	鬳
甘	甘
甙	弋	甘
甚	⑤	匹
甛	甘	舌
甜	甘	舌
甝	甘	虎
甞	甘	𫩠
生	生
甠	日	生
甡	生
產	厂	文	生
産	产	生
甤	生	豕
甥	生	男
甦	更	生
甧	月	甡
用	丨	二	冂
甩	乚	二	冂
甪	丿	用
甫	丶	十	月
甬	用	龴
甭	不	用
甮	勿	用
甯	用	𫲽
田	田
由	由
甲	甲
申	申
甴	丄	口
电	乚	日
甶	丿	田
男	力	田
甸	勹	田
甹	丂	由
町	丁	田
画	一	凵	田
甼	丁	田
甽	川	田
甾	巛	田
甿	亡	田
畀	丌	田
畁	丌	由
畂	久	田
畃	勺	申
畄	田	𭕄
畅	申	𠃓
畆	亩	厶
畇	勻	田
畈	反	田
畉	夫	田
畊	井	田
畋	攵	田
界	介	田
畍	介	田
畎	犬	田
畏	一	丿	乀	田	𠄌
畐	田	𠮛
畑	火	田
畒	亩	人
畓	水	田
畔	半	田
畕	田
畖	瓜	田
畗	亠	口	田
畘	冉	田
留	③	刀	田
畚	厶	大	田
畛	㐱	田
畜	玄	田
畝	久	亩
畞	十	畂
畟	八	夂	田
畠	田	白
畡	亥	田
畢	⑨	一
畣	合	田
畤	寺	田
略	各	田
畦	圭	田
畧	各	田
畨	田	米
畩	田	衣
番	田	釆
畫	一	田	𦘒
畬	余	田
畭	余	田
畮	每	田
畯	夋	田
異	共	田
畱	丣	田
畲	佘	田
畳	冝	田
畴	寿	田
畵	一	凵	田	𦘒
當	田	𫩠
畷	叕	田
畸	奇	田
畹	宛	田
畺	一	田
畻	土	田	龹
畼	昜	田
畽	田	重
畾	田
畿	戈	田	𢆶
疀	甾	疌
疁	田	翏
疂	丷	八	冝	田
疃	田	童
疄	田	粦
疅	田	畺
疆	土	弓	畺
疇	壽	田
疈	②	畐
疉	冖	彑	畾
疊	冝	畾
疋	疋
疌	疌
疍	旦	疋
疎	束	𤴔
疏	㐬	𤴔
疐	冖	十	田	疋
疑	疋	龴	𠤕
疒	疒
疓	乃	疒
疔	丁	疒
疕	匕	疒
疖	丨	疒	𠃌
疗	了	疒
疘	工	疒
疙	乞	疒
疚	久	疒
疛	寸	疒
疜	下	疒
疝	山	疒
疞	亏	疒
疟	一	匚	疒
疠	万	疒
疡	疒	𠃓
疢	火	疒
疣	尤	疒
疤	巴	疒
疥	介	疒
疦	夬	疒
疧	氏	疒
疨	牙	疒
疩	卆	疒
疪	比	疒
疫	殳	疒
疬	历	疒
疭	从	疒
疮	仓	疒
疯	疒	风
疰	主	疒
疱	包	疒
疲	疒	皮
疳	甘	疒
疴	可	疒
疵	此	疒
疶	世	疒
疷	氐	疒
疸	旦	疒
疹	㐱	疒
疺	乏	疒
疻	只	疒
疼	冬	疒
疽	且	疒
疾	疒	矢
疿	弗	疒
痀	句	疒
痁	占	疒
痂	加	疒
痃	玄	疒
痄	乍	疒
病	丙	疒
痆	尼	疒
症	正	疒
痈	用	疒
痉	疒	𢀖
痊	全	疒
痋	疒	虫
痌	同	疒
痍	夷	疒
痎	亥	疒
痏	有	疒
痐	回	疒
痑	多	疒
痒	疒	羊
痓	疒	至
痔	寺	疒
痕	疒	艮
痖	亚	疒
痗	每	疒
痘	疒	豆
痙	巠	疒
痚	孝	疒
痛	甬	疒
痜	疒	秃
痝	尨	疒
痞	否	疒
痟	疒	肖
痠	夋	疒
痡	甫	疒
痢	利	疒
痣	志	疒
痤	坐	疒
痥	兑	疒
痦	吾	疒
痧	沙	疒
痨	劳	疒
痩	疒	叟
痪	奂	疒
痫	疒	闲
痬	易	疒
痭	朋	疒
痮	疒	長
痯	官	疒
痰	炎	疒
痱	疒	非
痲	疒	𣏟
痳	林	疒
痴	疒	知
痵	季	疒
痶	典	疒
痷	奄	疒
痸	制	疒
痹	畀	疒
痺	卑	疒
痻	昏	疒
痼	固	疒
痽	疒	隹
痾	疒	阿
痿	委	疒
瘀	於	疒
瘁	卒	疒
瘂	亞	疒
瘃	疒	豖
瘄	昔	疒
瘅	单	疒
瘆	参	疒
瘇	疒	重
瘈	契	疒
瘉	俞	疒
瘊	侯	疒
瘋	疒	風
瘌	剌	疒
瘍	昜	疒
瘎	甚	疒
瘏	疒	者
瘐	疒	臾
瘑	咼	疒
瘒	疒	軍
瘓	奐	疒
瘔	疒	苦
瘕	叚	疒
瘖	疒	音
瘗	土	夹	疒
瘘	娄	疒
瘙	疒	蚤
瘚	欮	疒
瘛	恝	疒
瘜	息	疒
瘝	疒	眔
瘞	㾜	土
瘟	昷	疒
瘠	疒	脊
瘡	倉	疒
瘢	疒	般
瘣	疒	鬼
瘤	留	疒
瘥	差	疒
瘦	叟	疒
瘧	疒	虐
瘨	疒	真
瘩	疒	荅
瘪	仓	疒	自
瘫	疒	难
瘬	張	疒
瘭	疒	票
瘮	參	疒
瘯	族	疒
瘰	疒	累
瘱	㤲	疒
瘲	從	疒
瘳	疒	翏
瘴	疒	章
瘵	疒	祭
瘶	欶	疒
瘷	敕	疒
瘸	疒	𦙲
瘹	疒	釣
瘺	屚	疒
瘻	婁	疒
瘼	疒	莫
瘽	堇	疒
瘾	疒	隐
瘿	婴	疒
癀	疒	黄
癁	復	疒
療	尞	疒
癃	疒	隆
癄	焦	疒
癅	畱	疒
癆	勞	疒
癇	疒	閒
癈	疒	發
癉	單	疒
癊	疒	陰
癋	惡	疒
癌	嵒	疒
癍	斑	疒
癎	疒	間
癏	疒	睘
癐	會	疒
癑	疒	農
癒	愈	疒
癓	微	疒
癔	意	疒
癕	疒	雍
癖	疒	辟
癗	疒	雷
癘	疒	萬
癙	疒	鼠
癚	疒	詹
癛	疒	稟
癜	殿	疒
癝	疒	禀
癞	疒	赖
癟	侖	疒	自
癠	疒	齊
癡	疑	疒
癢	疒	養
癣	疒	鲜
癤	疒	節
癥	徵	疒
癦	墨	疒
癧	歷	疒
癨	疒	霍
癩	疒	賴
癪	疒	積
癫	疒	颠
癬	疒	鮮
癭	嬰	疒
癮	疒	隱
癯	疒	瞿
癰	疒	雝
癱	疒	難
癲	疒	顛
癳	疒	纍
癴	攣	疒
癵	疒	臠
癶	②	③
癷	干	癶
癸	天	癶
癹	殳	癶
発	二	儿	癶
登	癶	豆
發	癶	𭚧
白	白
百	一	白
癿	乚	白
皀	匕	白
皁	十	白
皂	七	白
皃	儿	白
的	勺	白
皅	巴	白
皆	比	白
皇	王	白
皈	反	白
皉	此	白
皊	令	白
皋	夲	白
皌	末	白
皍	白	𠨐
皎	交	白
皏	并	白
皐	白	𠦂
皑	岂	白
皒	我	白
皓	告	白
皔	旱	白
皕	百
皖	完	白
皗	周	白
皘	白	青
皙	析	白
皚	白	豈
皛	㿟	白
皜	白	高
皝	光	皇
皞	白	皋
皟	白	責
皠	崔	白
皡	白	皐
皢	堯	白
皣	白	華
皤	番	白
皥	白	臯
皦	敫	白
皧	愛	白
皨	土	皛
皩	晃	皇
皪	樂	白
皫	白	麃
皬	白	霍
皭	爵	白
皮	皮
皯	干	皮
皰	包	皮
皱	刍	皮
皲	军	皮
皳	求	皮
皴	夋	皮
皵	昔	皮
皶	查	皮
皷	壴	皮
皸	皮	軍
皹	皮	軍
皺	皮	芻
皻	皮	虘
皼	壹	皮
皽	亶	皮
皾	皮	賣
皿	皿
盀	卜	皿
盁	乃	皿
盂	于	皿
盃	不	皿
盄	弔	皿
盅	中	皿
盆	分	皿
盇	太	皿
盈	夃	皿
盉	皿	禾
益	䒑	八	皿
盋	犮	皿
盌	夗	皿
盍	去	皿
盎	央	皿
盏	戋	皿
盐	圤	皿
监	〢	丶	皿	𠂉
盒	合	皿
盓	汙	皿
盔	灰	皿
盕	汎	皿
盖	皿	𦍌
盗	次	皿
盘	皿	舟
盙	甫	皿
盚	求	皿
盛	成	皿
盜	㳄	皿
盝	录	皿
盞	戔	皿
盟	明	皿
盠	彖	皿
盡	皿	𭴘
盢	畎	皿
監	丶	皿	臣	𠂉
盤	皿	般
盥	水	皿	𦥑
盦	皿	酓
盧	田	皿	虍
盨	皿	須
盩	皿	𪯎
盪	湯	皿
盫	皿	𨠭
盬	古	皿	臣	𠂉
盭	皿	𢿐
目	目
盯	丁	目
盰	干	目
盱	于	目
盲	亡	目
盳	亡	目
直	一	且	十
盵	乞	目
盶	元	目
盷	匀	目
相	木	目
盹	屯	目
盺	斤	目
盻	兮	目
盼	分	目
盽	丰	目
盾	𠂆	𥃭
盿	文	目
眀	月	目
省	少	目
眂	氏	目
眃	云	目
眄	丏	目
眅	反	目
眆	方	目
眇	少	目
眈	冘	目
眉	目	𠃜
眊	毛	目
看	目	龵
県	小	目	𠃊
眍	区	目
眎	目	示
眏	央	目
眐	正	目
眑	幼	目
眒	申	目
眓	戉	目
眔	⑤	罒
眕	㐱	目
眖	兄	目
眗	句	目
眘	目	𡗜
眙	台	目
眚	生	目
眛	未	目
眜	末	目
眝	宁	目
眞	八	匕	目	𠃊
真	具	十
眠	民	目
眡	氐	目
眢	夗	目
眣	失	目
眤	尼	目
眥	此	目
眦	此	目
眧	召	目
眨	乏	目
眩	玄	目
眪	丙	目
眫	半	目
眬	目	龙
眭	圭	目
眮	同	目
眯	目	米
眰	目	至
眱	夷	目
眲	目	耳
眳	名	目
眴	旬	目
眵	多	目
眶	匡	目
眷	目	龹
眸	牟	目
眹	关	目
眺	兆	目
眻	目	羊
眼	目	艮
眽	目	𠂢
眾	乑	罒
眿	永	目
着	目	羊
睁	争	目
睂	丨	仌	厂	目
睃	夋	目
睄	目	肖
睅	旱	目
睆	完	目
睇	弟	目
睈	呈	目
睉	坐	目
睊	目	肙
睋	我	目
睌	免	目
睍	目	見
睎	希	目
睏	困	目
睐	来	目
睑	佥	目
睒	炎	目
睓	典	目
睔	侖	目
睕	宛	目
睖	夌	目
睗	易	目
睘	罒	𠮛	𧘇
睙	戾	目
睚	厓	目
睛	目	青
睜	爭	目
睝	目	𥝢
睞	來	目
睟	卒	目
睠	卷	目
睡	垂	目
睢	目	隹
督	叔	目
睤	畀	目
睥	卑	目
睦	坴	目
睧	昏	目
睨	兒	目
睩	录	目
睪	幸	罒
睫	疌	目
睬	目	采
睭	周	目
睮	俞	目
睯	敃	目
睰	目	若
睱	叚	目
睲	星	目
睳	奎	目
睴	目	軍
睵	哉	目
睶	春	目
睷	建	目
睸	目	眉
睹	目	者
睺	侯	目
睻	宣	目
睼	是	目
睽	癸	目
睾	丿	睪
睿	八	𣦵	𥃦
瞀	敄	目
瞁	狊	目
瞂	犮	盾
瞃	目	盾
瞄	目	苗
瞅	目	秋
瞆	目	贵
瞇	目	迷
瞈	目	翁
瞉	一	冖	士	殳	目
瞊	唐	目
瞋	目	真
瞌	盍	目
瞍	叟	目
瞎	害	目
瞏	罒	袁
瞐	䀠	目
瞑	冥	目
瞒	目	𬜯
瞓	目	訓
瞔	目	責
瞕	目	章
瞖	殹	目
瞗	目	鳥
瞘	區	目
瞙	目	莫
瞚	寅	目
瞛	從	目
瞜	婁	目
瞝	目	离
瞞	㒼	目
瞟	目	票
瞠	堂	目
瞡	目	規
瞢	冖	目	𦭝
瞣	患	目
瞤	目	閏
瞥	敝	目
瞦	喜	目
瞧	焦	目
瞨	目	菐
瞩	属	目
瞪	登	目
瞫	目	覃
瞬	目	舜
瞭	尞	目
瞮	攵	目	育
瞯	目	閒
瞰	敢	目
瞱	目	華
瞲	目	矞
瞳	目	童
瞴	無	目
瞵	目	粦
瞶	目	貴
瞷	目	間
瞸	目	葉
瞹	愛	目
瞺	會	目
瞻	目	詹
瞼	僉	目
瞽	目	鼓
瞾	䀠	空
瞿	䀠	隹
矀	微	目
矁	愁	目
矂	喿	目
矃	寧	目
矄	熏	目
矅	目	翟
矆	目	蒦
矇	目	蒙
矈	方	白	目	穴
矉	目	賓
矊	目	綿
矋	厲	目
矌	廣	目
矍	又	瞿
矎	夐	目
矏	目	臱
矐	目	霍
矑	盧	目
矒	目	瞢
矓	目	龍
矔	目	雚
矕	䜌	目
矖	目	麗
矗	直
矘	目	黨
矙	目	闞
矚	屬	目
矛	丿	龴	𠄐
矜	今	矛
矝	令	矛
矞	冏	矛
矟	矛	肖
矠	昔	矛
矡	矍	矛
矢	大	𠂉
矣	厶	矢
矤	弓	矢
知	口	矢
矦	厃	矢
矧	引	矢
矨	夭	矢
矩	巨	矢
矪	矢	舟
矫	乔	矢
矬	坐	矢
短	矢	豆
矮	委	矢
矯	喬	矢
矰	曾	矢
矱	矢	蒦
矲	矢	罷
石	丆	口
矴	丁	石
矵	刂	石
矶	几	石
矷	子	石
矸	干	石
矹	兀	石
矺	乇	石
矻	乞	石
矼	工	石
矽	夕	石
矾	凡	石
矿	广	石
砀	石	𠃓
码	石	马
砂	少	石
砃	丹	石
砄	夬	石
砅	水	石
砆	夫	石
砇	文	石
砈	厄	石
砉	丰	石
砊	亢	石
砋	止	石
砌	切	石
砍	欠	石
砎	介	石
砏	分	石
砐	及	石
砑	牙	石
砒	比	石
砓	殳	石
研	开	石
砕	卆	石
砖	专	石
砗	石	车
砘	屯	石
砙	瓦	石
砚	石	见
砛	今	石
砜	石	风
砝	去	石
砞	末	石
砟	乍	石
砠	且	石
砡	玉	石
砢	可	石
砣	它	石
砤	㐌	石
砥	氐	石
砦	此	石
砧	占	石
砨	戹	石
砩	弗	石
砪	母	石
砫	主	石
砬	石	立
砭	乏	石
砮	奴	石
砯	氷	石
砰	平	石
砱	令	石
砲	包	石
砳	石
破	皮	石
砵	本	石
砶	白	石
砷	申	石
砸	匝	石
砹	石	艾
砺	厉	石
砻	石	龙
砼	仝	石
砽	用	石
砾	乐	石
砿	広	石
础	出	石
硁	石	𢀖
硂	全	石
硃	朱	石
硄	光	石
硅	圭	石
硆	合	石
硇	囟	石
硈	吉	石
硉	石	聿
硊	危	石
硋	亥	石
硌	各	石
硍	石	艮
硎	刑	石
硏	幵	石
硐	同	石
硑	并	石
硒	石	西
硓	石	老
硔	共	石
硕	石	页
硖	夹	石
硗	尧	石
硘	回	石
硙	岂	石
硚	乔	石
硛	亦	石
硜	巠	石
硝	石	肖
硞	告	石
硟	延	石
硠	石	良
硡	宏	石
硢	余	石
硣	孝	石
硤	夾	石
硥	尨	石
硦	弄	石
硧	甬	石
硨	石	車
硩	折	石
硪	我	石
硫	㐬	石
硬	更	石
硭	石	芒
确	石	角
硯	石	見
硰	沙	石
硱	困	石
硲	石	谷
硳	石	赤
硴	石	花
硵	卤	石
硶	岑	石
硷	佥	石
硸	岸	石
硹	松	石
硺	石	豖
硻	石	臤
硼	朋	石
硽	奄	石
硾	垂	石
硿	石	空
碀	争	石
碁	其	石
碂	宗	石
碃	石	青
碄	林	石
碅	囷	石
碆	波	石
碇	定	石
碈	昏	石
碉	周	石
碊	戔	石
碋	岢	石
碌	录	石
碍	㝵	石
碎	卒	石
碏	昔	石
碐	夌	石
碑	卑	石
碒	石	金
碓	石	隹
碔	武	石
碕	奇	石
碖	侖	石
碗	宛	石
碘	典	石
碙	岡	石
碚	咅	石
碛	石	责
碜	参	石
碝	石	耎
碞	品	石
碟	枼	石
碠	亭	石
碡	毒	石
碢	咼	石
碣	曷	石
碤	石	英
碥	扁	石
碦	客	石
碧	珀	石
碨	畏	石
碩	石	頁
碪	甚	石
碫	段	石
碬	叚	石
碭	昜	石
碮	是	石
碯	石	𡿺
碰	並	石
碱	咸	石
碲	帝	石
碳	炭	石
碴	查	石
碵	石	貞
碶	契	石
碷	盾	石
碸	石	風
碹	宣	石
確	石	隺
碻	石	高
碼	石	馬
碽	石	貢
碾	展	石
碿	屑	石
磀	石	逆
磁	兹	石
磂	留	石
磃	石	虒
磄	唐	石
磅	旁	石
磆	石	骨
磇	石	𣬉
磈	石	鬼
磉	桑	石
磊	石	砳
磋	差	石
磌	真	石
磍	害	石
磎	奚	石
磏	兼	石
磐	石	般
磑	石	豈
磒	員	石
磓	石	追
磔	桀	石
磕	盍	石
磖	石	習
磗	尃	石
磘	䍃	石
磙	石	衮
磚	專	石
磛	斬	石
磜	石	祭
磝	敖	石
磞	崩	石
磟	石	翏
磠	石	鹵
磡	勘	石
磢	爽	石
磣	參	石
磤	殷	石
磥	石	累
磦	石	票
磧	石	責
磨	石	麻
磩	戚	石
磪	崔	石
磫	從	石
磬	殸	石
磭	石	脣
磮	崙	石
磯	幾	石
磰	善	石
磱	勞	石
磲	渠	石
磳	曾	石
磴	登	石
磵	石	間
磶	石	舄
磷	石	粦
磸	奠	石
磹	石	覃
磺	石	黄
磻	番	石
磼	石	集
磽	堯	石
磾	單	石
磿	厤	石
礀	石	閒
礁	焦	石
礂	喜	石
礃	掌	石
礄	喬	石
礅	敦	石
礆	僉	石
礇	奥	石
礈	石	遂
礉	敫	石
礊	石	𣪠
礋	睪	石
礌	石	雷
礍	石	葛
礎	楚	石
礏	業	石
礐	石	𦥯
礑	當	石
礒	石	義
礓	畺	石
礔	石	辟
礕	石	辟
礖	石	與
礗	石	賓
礘	㬎	石
礙	疑	石
礚	石	蓋
礛	監	石
礜	石	與
礝	石	需
礞	石	蒙
礟	石	駁
礠	慈	石
礡	石	蒪
礢	石	養
礣	石	蔑
礤	石	蔡
礥	石	賢
礦	廣	石
礧	畾	石
礨	畾	石
礩	石	質
礪	厲	石
礫	樂	石
礬	樊	石
礭	石	霍
礮	石	駮
礯	石	縈
礰	歷	石
礱	石	龍
礲	石	龍
礳	石	磨
礴	石	薄
礵	石	霜
礶	石	雚
礷	石	藍
礸	石	贊
礹	嚴	石
示	示
礻	礻
礼	乚	礻
礽	乃	礻
社	土	礻
礿	勺	礻
祀	巳	礻
祁	礻	阝
祂	也	礻
祃	礻	马
祄	介	礻
祅	夭	礻
祆	天	礻
祇	氏	礻
祈	斤	礻
祉	止	礻
祊	方	礻
祋	殳	礻
祌	中	礻
祍	壬	礻
祎	礻	韦
祏	石	礻
祐	右	礻
祑	失	礻
祒	召	礻
祓	犮	礻
祔	付	礻
祕	必	礻
祖	且	礻
祗	氐	礻
祘	示
祙	未	礻
祚	乍	礻
祛	去	礻
祜	古	礻
祝	兄	礻
神	申	礻
祟	出	示
祠	司	礻
祡	此	示
祢	尔	礻
祣	④	礻	𠂉
祤	礻	羽
祥	礻	羊
祦	吴	礻
祧	兆	礻
票	示	覀
祩	朱	礻
祪	危	礻
祫	合	礻
祬	礻	至
祭	②	冫	示	𠂊
祮	吉	礻
祯	礻	贞
祰	告	礻
祱	兑	礻
祲	礻	𠬶
祳	礻	辰
祴	戒	礻
祵	困	礻
祶	弟	礻
祷	寿	礻
祸	呙	礻
祹	匋	礻
祺	其	礻
祻	固	礻
祼	果	礻
祽	卒	礻
祾	夌	礻
祿	彔	礻
禀	㐭	示
禁	林	示
禂	周	礻
禃	直	礻
禄	录	礻
禅	单	礻
禆	卑	礻
禇	礻	者
禈	礻	軍
禉	礻	酋
禊	契	礻
禋	垔	礻
禌	兹	礻
禍	咼	礻
禎	礻	貞
福	畐	礻
禐	爰	礻
禑	礻	禺
禒	彖	礻
禓	昜	礻
禔	是	礻
禕	礻	韋
禖	某	礻
禗	思	礻
禘	帝	礻
禙	礻	背
禚	礻	羔
禛	真	礻
禜	示	𤇾
禝	畟	礻
禞	礻	高
禟	唐	礻
禠	礻	虒
禡	礻	馬
禢	礻	𦐇
禣	尃	礻
禤	礻	罒	羽
禥	基	礻
禦	御	示
禧	喜	礻
禨	幾	礻
禩	異	礻
禪	單	礻
禫	礻	覃
禬	會	礻
禭	礻	遂
禮	礻	豊
禯	礻	農
禰	爾	礻
禱	壽	礻
禲	厲	礻
禳	礻	襄
禴	礻	龠
禵	礻	題
禶	礻	贊
禷	礻	類
禸	冂	厶
禹	禹
禺	禺
离	㐫	禸
禼	卤	禸
禽	人	离
禾	丿	木
禿	儿	禾
秀	乃	禾
私	厶	禾
秂	人	禾
秃	几	禾
秄	子	禾
秅	乇	禾
秆	干	禾
秇	丸	禾
秈	山	禾
秉	コ	一	禾
秊	千	禾
秋	火	禾
秌	火	禾
种	中	禾
秎	分	禾
秏	毛	禾
秐	云	禾
科	斗	禾
秒	少	禾
秓	支	禾
秔	亢	禾
秕	比	禾
秖	氏	禾
秗	夭	禾
秘	必	禾
秙	古	禾
秚	半	禾
秛	皮	禾
秜	尼	禾
秝	禾
秞	由	禾
租	且	禾
秠	丕	禾
秡	犮	禾
秢	令	禾
秣	末	禾
秤	平	禾
秥	占	禾
秦	禾	𡗗
秧	央	禾
秨	乍	禾
秩	失	禾
秪	氐	禾
秫	术	禾
秬	巨	禾
秭	禾	𠂔
秮	台	禾
积	只	禾
称	尔	禾
秱	同	禾
秲	寺	禾
秳	禾	舌
秴	合	禾
秵	因	禾
秶	次	禾
秷	禾	至
秸	吉	禾
秹	任	禾
秺	宅	禾
移	多	禾
秼	朱	禾
秽	岁	禾
秾	农	禾
秿	甫	禾
稀	希	禾
稁	亠	冖	口	禾
稂	禾	良
稃	孚	禾
稄	夋	禾
稅	兌	禾
稆	吕	禾
稇	困	禾
稈	旱	禾
稉	更	禾
稊	弟	禾
程	呈	禾
稌	余	禾
稍	禾	肖
税	兑	禾
稏	亞	禾
稐	侖	禾
稑	坴	禾
稒	固	禾
稓	昔	禾
稔	念	禾
稕	享	禾
稖	咅	禾
稗	卑	禾
稘	其	禾
稙	直	禾
稚	禾	隹
稛	囷	禾
稜	夌	禾
稝	朋	禾
稞	果	禾
稟	㐭	禾
稠	周	禾
稡	卒	禾
稢	或	禾
稣	禾	鱼
稤	京	禾
稥	日	𤇕
稦	禾	韋
稧	契	禾
稨	扁	禾
稩	禾	胃
稪	复	禾
稫	畐	禾
稬	禾	耎
稭	皆	禾
種	禾	重
稯	㚇	禾
稰	禾	胥
稱	爯	禾
稲	旧	爫	禾
稳	急	禾
稴	兼	禾
稵	兹	禾
稶	彧	禾
稷	畟	禾
稸	畜	禾
稹	真	禾
稺	屖	禾
稻	禾	舀
稼	家	禾
稽	尤	旨	禾
稾	禾	高
稿	禾	高
穀	殳	𥞤
穁	禾	茸
穂	恵	禾
穃	容	禾
穄	祭	禾
穅	康	禾
穆	㣎	禾
穇	參	禾
穈	禾	麻
穉	犀	禾
穊	既	禾
穋	禾	翏
穌	禾	魚
積	禾	責
穎	匕	禾	頁
穏	禾	𢚩
穐	亀	禾
穑	啬	禾
穒	禾	鳥
穓	異	禾
穔	禾	黄
穕	禾	集
穖	幾	禾
穗	惠	禾
穘	堯	禾
穙	禾	菐
穚	喬	禾
穛	焦	禾
穜	禾	童
穝	最	禾
穞	禾	鲁
穟	禾	遂
穠	禾	農
穡	嗇	禾
穢	歲	禾
穣	㐮	禾
穤	禾	需
穥	禾	與
穦	禾	賓
穧	禾	齊
穨	秃	貴
穩	㥯	禾
穪	爾	禾
穫	禾	蒦
穬	廣	禾
穭	禾	魯
穮	禾	麃
穯	吅	回	土	禾
穰	禾	襄
穱	爵	禾
穲	禾	麗
穳	禾	贊
穴	八	宀
穵	乙	穴
究	九	穴
穷	力	穴
穸	夕	穴
穹	弓	穴
空	工	穴
穻	于	穴
穼	木	穴
穽	井	穴
穾	夭	穴
穿	牙	穴
窀	屯	穴
突	犬	穴
窂	牛	穴
窃	切	穴
窄	乍	穴
窅	目	穴
窆	乏	穴
窇	包	穴
窈	幼	穴
窉	丙	穴
窊	瓜	穴
窋	出	穴
窌	卯	穴
窍	巧	穴
窎	穴	鸟
窏	汙	穴
窐	圭	穴
窑	穴	缶
窒	穴	至
窓	厶	心	穴
窔	交	穴
窕	兆	穴
窖	告	穴
窗	囱	穴
窘	君	穴
窙	孝	穴
窚	成	穴
窛	元	女	穴
窜	串	穴
窝	呙	穴
窞	穴	臽
窟	屈	穴
窠	果	穴
窡	叕	穴
窢	或	穴
窣	卒	穴
窤	昆	穴
窥	穴	规
窦	卖	穴
窧	卓	穴
窨	穴	音
窩	咼	穴
窪	洼	穴
窫	契	穴
窬	俞	穴
窭	娄	穴
窮	穴	躬
窯	穴	羔
窰	䍃	穴
窱	條	穴
窲	料	穴
窳	㼌	穴
窴	真	穴
窵	穴	鳥
窶	婁	穴
窷	穴	聊
窸	悉	穴
窹	穴	𤕻
窺	穴	規
窻	悤	穴
窼	巢	穴
窽	欵	穴
窾	款	穴
窿	穴	隆
竀	正	穴	見
竁	毳	穴
竂	尞	穴
竃	土	日	电	穴
竄	穴	鼠
竅	敫	穴
竆	穴	躳
竇	穴	賣
竈	土	穴	黽
竉	穴	龍
竊	⺊	禸	穴	釆	𠔿
立	一	丷	亠
竌	几	立
竍	十	立
竎	廾	立
竏	千	立
竐	殳	立
竑	厷	立
竒	丷	亠	可
竓	毛	立
竔	升	立
竕	分	立
竖	〢	又	立
竗	少	立
竘	句	立
站	占	立
竚	宁	立
竛	令	立
竜	乚	日	立
竝	立
竞	兄	立
竟	儿	音
章	早	立
竡	百	立
竢	矣	立
竣	夋	立
竤	宏	立
童	立	里
竦	束	立
竧	立	身
竨	卓	立
竩	宜	立
竪	立	臤
竫	争	立
竬	禹	立
竭	曷	立
竮	屏	立
端	立	耑
竰	厘	立
竱	專	立
竲	曾	立
竳	登	立
竴	尊	立
竵	立	𩰬
競	竞
竷	夂	夅	章
竸	竟
竹	亇
竺	二	竹
竻	力	竹
竼	凡	竹
竽	于	竹
竾	也	竹
竿	干	竹
笀	亡	竹
笁	工	竹
笂	丸	竹
笃	竹	马
笄	开	竹
笅	爻	竹
笆	巴	竹
笇	卞	竹
笈	及	竹
笉	匀	竹
笊	爪	竹
笋	尹	竹
笌	牙	竹
笍	内	竹
笎	元	竹
笏	勿	竹
笐	亢	竹
笑	夭	竹
笒	今	竹
笓	比	竹
笔	毛	竹
笕	竹	见
笖	以	竹
笗	冬	竹
笘	占	竹
笙	生	竹
笚	甲	竹
笛	由	竹
笜	出	竹
笝	㘝	竹
笞	台	竹
笟	瓜	竹
笠	立	竹
笡	且	竹
笢	民	竹
笣	包	竹
笤	召	竹
笥	司	竹
符	付	竹
笧	册	竹
笨	本	竹
笩	代	竹
笪	旦	竹
笫	竹	𠂔
第	竹	𢎨
笭	令	竹
笮	乍	竹
笯	奴	竹
笰	弗	竹
笱	句	竹
笲	弁	竹
笳	加	竹
笴	可	竹
笵	氾	竹
笶	矢	竹
笷	卯	竹
笸	叵	竹
笹	世	竹
笺	戋	竹
笻	卭	竹
笼	竹	龙
笽	皿	竹
笾	竹	边
笿	各	竹
筀	圭	竹
筁	曲	竹
筂	池	竹
筃	因	竹
筄	兆	竹
筅	先	竹
筆	竹	聿
筇	竹	邛
筈	竹	舌
等	寺	竹
筊	交	竹
筋	竹	肋
筌	全	竹
筍	旬	竹
筎	如	竹
筏	伐	竹
筐	匡	竹
筑	巩	竹
筒	同	竹
筓	幵	竹
答	合	竹
筕	竹	行
策	朿	竹
筗	仲	竹
筘	扣	竹
筙	竹	耒
筚	十	笓
筛	师	竹
筜	当	竹
筝	争	竹
筞	宋	竹
筟	孚	竹
筠	均	竹
筡	余	竹
筢	把	竹
筣	利	竹
筤	竹	良
筥	吕	竹
筦	完	竹
筧	竹	見
筨	含	竹
筩	甬	竹
筪	匣	竹
筫	竹	貝
筬	成	竹
筭	弄	竹
筮	巫	竹
筯	助	竹
筰	作	竹
筱	攸	竹
筲	竹	肖
筳	廷	竹
筴	夾	竹
筵	延	竹
筶	告	竹
筷	快	竹
筸	旱	竹
筹	寿	竹
筺	匤	竹
筻	更	竹
筼	员	竹
筽	吴	竹
签	佥	竹
筿	条	竹
简	竹	间
箁	咅	竹
箂	來	竹
箃	取	竹
箄	卑	竹
箅	畀	竹
箆	比	竹	𠔿
箇	固	竹
箈	治	竹
箉	拐	竹
箊	於	竹
箋	戔	竹
箌	到	竹
箍	㧜	竹
箎	竹	虎
箏	爭	竹
箐	竹	青
箑	疌	竹
箒	帚	竹
箓	录	竹
箔	泊	竹
箕	其	竹
箖	林	竹
算	竹	𥃲
箘	囷	竹
箙	服	竹
箚	㓣	竹
箛	孤	竹
箜	空	竹
箝	拑	竹
箞	卷	竹
箟	昆	竹
箠	垂	竹
管	官	竹
箢	宛	竹
箣	刺	竹
箤	卒	竹
箥	波	竹
箦	竹	责
箧	匚	夹	竹
箨	择	竹
箩	竹	罗
箪	单	竹
箫	竹	肃
箬	竹	若
箭	前	竹
箮	宣	竹
箯	便	竹
箰	子	筍
箱	相	竹
箲	洗	竹
箳	屏	竹
箴	咸	竹
箵	省	竹
箶	竹	胡
箷	施	竹
箸	竹	者
箹	竹	約
箺	春	竹
箻	律	竹
箼	屋	竹
箽	竹	重
箾	削	竹
箿	咠	竹
節	即	竹
篁	皇	竹
篂	星	竹
篃	眉	竹
範	竹	𨊠
篅	竹	耑
篆	彖	竹
篇	扁	竹
篈	封	竹
築	木	筑
篊	洪	竹
篋	匧	竹
篌	侯	竹
篍	秋	竹
篎	眇	竹
篏	竹	𣢟
篐	竹	𣐝
篑	竹	贵
篒	竹	食
篓	娄	竹
篔	員	竹
篕	盍	竹
篖	唐	竹
篗	竹	隻
篘	竹	芻
篙	竹	高
篚	匪	竹
篛	弱	竹
篜	烝	竹
篝	冓	竹
篞	涅	竹
篟	倩	竹
篠	條	竹
篡	厶	𮅕
篢	竹	貢
篣	旁	竹
篤	竹	馬
篥	栗	竹
篦	竹	𣬉
篧	竹	隺
篨	竹	除
篩	師	竹
篪	竹	虒
篫	手	筑
篬	倉	竹
篭	竜	竹
篮	监	竹
篯	竹	钱
篰	竹	部
篱	离	竹
篲	彗	竹
篳	畢	竹
篴	竹	逐
篵	從	竹
篶	焉	竹
篷	竹	逢
篸	參	竹
篹	㔾	𮅕
篺	捭	竹
篻	票	竹
篼	兜	竹
篽	御	竹
篾	戍	竹	罒
篿	專	竹
簀	竹	責
簁	徙	竹
簂	國	竹
簃	移	竹
簄	扈	竹
簅	産	竹
簆	竹	𡨥
簇	族	竹
簈	屛	竹
簉	竹	造
簊	基	竹
簋	皿	竹	艮
簌	欶	竹
簍	婁	竹
簎	措	竹
簏	竹	鹿
簐	竹	軟
簑	竹	衰
簒	么	𮅕
簓	彫	竹
簔	竹	衰
簕	勒	竹
簖	断	竹
簗	梁	竹
簘	竹	粛
簙	博	竹
簚	巾	戈	竹	罒
簛	斯	竹
簜	湯	竹
簝	尞	竹
簞	單	竹
簟	竹	覃
簠	盙	竹
簡	竹	間
簢	竹	閔
簣	竹	貴
簤	竹	買
簥	喬	竹
簦	登	竹
簧	竹	黄
簨	巽	竹
簩	勞	竹
簪	朁	竹
簫	竹	肅
簬	竹	路
簭	㕣	筮
簮	替	竹
簯	棋	竹
簰	牌	竹
簱	竹	𣄃
簲	竹	脾
簳	幹	竹
簴	竹	虡
簵	竹	輅
簶	禄	竹
簷	竹	詹
簸	竹	𤿺
簹	當	竹
簺	塞	竹
簻	竹	過
簼	搆	竹
簽	僉	竹
簾	廉	竹
簿	溥	竹
籀	㨨	竹
籁	竹	赖
籂	竹	飾
籃	監	竹
籄	匱	竹
籅	竹	與
籆	竹	蒦
籇	竹	豪
籈	甄	竹
籉	竹	臺
籊	竹	翟
籋	爾	竹
籌	壽	竹
籍	竹	耤
籎	疑	竹
籏	旗	竹
籐	滕	竹
籑	良	𮅕
籒	㩅	竹
籓	潘	竹
籔	數	竹
籕	榴	竹
籖	竹	韯
籗	竹	霍
籘	竹	縢
籙	竹	録
籚	盧	竹
籛	竹	錢
籜	擇	竹
籝	嬴	竹
籞	禦	竹
籟	竹	賴
籠	竹	龍
籡	撿	竹
籢	斂	竹
籣	竹	闌
籤	竹	韱
籥	竹	龠
籦	竹	鍾
籧	竹	遽
籨	歛	竹
籩	竹	邊
籪	斷	竹
籫	竹	贊
籬	竹	離
籭	竹	麗
籮	竹	羅
籯	竹	贏
籰	矍	竹
籱	竹	靃
籲	竹	龥
米	米
籴	入	米
籵	十	米
籶	几	米
籷	乇	米
籸	卂	米
籹	女	米
籺	乞	米
类	大	米
籼	山	米
籽	子	米
籾	刃	米
籿	寸	米
粀	丈	米
粁	千	米
粂	久	米
粃	比	米
粄	反	米
粅	勿	米
粆	少	米
粇	亢	米
粈	丑	米
粉	分	米
粊	比	米
粋	卆	米
粌	引	米
粍	毛	米
粎	尺	米
粏	太	米
粐	户	米
粑	巴	米
粒	立	米
粓	甘	米
粔	巨	米
粕	白	米
粖	末	米
粗	且	米
粘	占	米
粙	由	米
粚	㐌	米
粛	粛
粜	出	米
粝	厉	米
粞	米	西
粟	米	覀
粠	共	米
粡	同	米
粢	次	米
粣	册	米
粤	丂	丿	囗	米
粥	弓	米
粦	米	舛
粧	庄	米
粨	百	米
粩	米	老
粪	共	米
粫	米	而
粬	曲	米
粭	合	米
粮	米	良
粯	米	見
粰	孚	米
粱	刅	氵	米
粲	米	𣦼
粳	更	米
粴	米	里
粵	丂	丿	囗	釆
粶	录	米
粷	匊	米
粸	其	米
粹	卒	米
粺	卑	米
粻	米	長
粼	巜	粦
粽	宗	米
精	米	青
粿	果	米
糀	米	花
糁	参	米
糂	甚	米
糃	昜	米
糄	扁	米
糅	柔	米
糆	米	面
糇	侯	米
糈	米	胥
糉	㚇	米
糊	米	胡
糋	前	米
糌	昝	米
糍	兹	米
糎	厘	米
糏	屑	米
糐	尃	米
糑	弱	米
糒	米	𤰇
糓	一	冖	士	殳	米
糔	米	蚤
糕	米	羔
糖	唐	米
糗	米	臭
糘	家	米
糙	米	造
糚	米	莊
糛	堂	米
糜	米	麻
糝	參	米
糞	異	米
糟	曹	米
糠	康	米
糡	竟	米
糢	米	莫
糣	朁	米
糤	散	米
糥	米	𦓔
糦	喜	米
糧	米	量
糨	强	米
糩	會	米
糪	米	辟
糫	睘	米
糬	米	署
糭	米	𡕰
糮	監	米
糯	米	需
糰	團	米
糱	米	辥
糲	厲	米
糳	米	𣫞
糴	籴	翟
糵	米	薛
糶	粜	翟
糷	米	蘭
糸	小	幺
糹	③	幺
糺	乚	糹
系	丿	糸
糼	力	糹
糽	丁	糹
糾	丩	糹
糿	刀	糹
紀	己	糹
紁	叉	糹
紂	寸	糹
紃	川	糹
約	勺	糹
紅	工	糹
紆	于	糹
紇	乞	糹
紈	丸	糹
紉	刃	糹
紊	文	糸
紋	文	糹
紌	尤	糹
納	内	糹
紎	犬	糹
紏	斗	糹
紐	丑	糹
紑	不	糹
紒	介	糹
紓	予	糹
純	屯	糹
紕	比	糹
紖	引	糹
紗	少	糹
紘	厷	糹
紙	氏	糹
級	及	糹
紛	分	糹
紜	云	糹
紝	壬	糹
紞	冘	糹
紟	今	糹
素	糸	龶
紡	方	糹
索	冖	十	糸
紣	卆	糹
紤	斤	糹
紥	扎	糸
紦	巴	糹
紧	〢	又	糸
紨	付	糹
紩	失	糹
紪	此	糹
紫	此	糸
紬	由	糹
紭	弘	糹
紮	札	糸
累	田	糸
細	田	糹
紱	犮	糹
紲	世	糹
紳	申	糹
紴	皮	糹
紵	宁	糹
紶	去	糹
紷	令	糹
紸	主	糹
紹	召	糹
紺	甘	糹
紻	央	糹
紼	弗	糹
紽	它	糹
紾	㐱	糹
紿	台	糹
絀	出	糹
絁	㐌	糹
終	冬	糹
絃	玄	糹
組	且	糹
絅	冋	糹
絆	半	糹
絇	句	糹
絈	白	糹
絉	术	糹
絊	本	糹
絋	広	糹
経	圣	糹
絍	任	糹
絎	糹	行
絏	曳	糹
結	吉	糹
絑	朱	糹
絒	州	糹
絓	圭	糹
絔	百	糹
絕	刀	巴	糹
絖	光	糹
絗	回	糹
絘	次	糹
絙	亘	糹
絚	亙	糹
絛	丨	亻	夂	糸
絜	㓞	糸
絝	夸	糹
絞	交	糹
絟	全	糹
絠	有	糹
絡	各	糹
絢	旬	糹
絣	并	糹
絤	糹	西
絥	伏	糹
給	合	糹
絧	同	糹
絨	戎	糹
絩	兆	糹
絪	因	糹
絫	厽	糸
絬	糹	舌
絭	糸	龹
絮	如	糸
絯	亥	糹
絰	糹	至
統	充	糹
絲	糸	糹
絳	夅	糹
絴	糹	羊
絵	会	糹
絶	糹	色
絷	执	糸
絸	糹	見
絹	糹	肙
絺	希	糹
絻	免	糹
絼	糹	豸
絽	吕	糹
絾	成	糹
絿	求	糹
綀	束	糹
綁	糹	邦
綂	糹	𠑽
綃	糹	肖
綄	完	糹
綅	糹	𠬶
綆	更	糹
綇	糹	酉
綈	弟	糹
綉	秀	糹
綊	夾	糹
綋	宏	糹
綌	糹	谷
綍	孛	糹
綎	廷	糹
綏	妥	糹
綐	兑	糹
綑	困	糹
綒	孚	糹
經	巠	糹
綔	夸	系
綕	志	糹
綖	延	糹
綗	冏	糹
綘	夆	糹
継	米	糹	𠃊
続	売	糹
綛	忍	糹
綜	宗	糹
綝	林	糹
綞	垂	糹
綟	戾	糹
綠	彔	糹
綡	京	糹
綢	周	糹
綣	卷	糹
綤	糸	邵
綥	畀	糹
綦	其	糸
綧	享	糹
綨	其	糹
綩	宛	糹
綪	糹	青
綫	戔	糹
綬	受	糹
維	糹	隹
綮	糸	𢼄
綯	匋	糹
綰	官	糹
綱	岡	糹
網	糹	罔
綳	朋	糹
綴	叕	糹
綵	糹	采
綶	果	糹
綷	卒	糹
綸	侖	糹
綹	咎	糹
綺	奇	糹
綻	定	糹
綼	卑	糹
綽	卓	糹
綾	夌	糹
綿	帛	糹
緀	妻	糹
緁	疌	糹
緂	炎	糹
緃	从	糹	龰
緄	昆	糹
緅	取	糹
緆	易	糹
緇	甾	糹
緈	幸	糹
緉	兩	糹
緊	糸	臤
緋	糹	非
緌	委	糹
緍	昏	糹
緎	或	糹
総	忩	糹
緐	每	系
緑	录	糹
緒	糹	者
緓	糹	英
緔	尚	糹
緕	斉	糹
緖	糹	者
緗	相	糹
緘	咸	糹
緙	糹	革
線	泉	糹
緛	糹	耎
緜	帛	系
緝	咠	糹
緞	段	糹
緟	糹	重
締	帝	糹
緡	昬	糹
緢	糹	苗
緣	彖	糹
緤	枼	糹
緥	保	糹
緦	思	糹
緧	糹	酋
編	扁	糹
緩	爰	糹
緪	恆	糹
緫	怱	糹
緬	糹	面
緭	糹	胃
緮	复	糹
緯	糹	韋
緰	俞	糹
緱	侯	糹
緲	眇	糹
緳	广	絜
練	柬	糹
緵	㚇	糹
緶	便	糹
緷	糹	軍
緸	垔	糹
緹	是	糹
緺	咼	糹
緻	糹	致
緼	昷	糹
緽	糹	貞
緾	厘	糹
緿	怠	糹
縀	叚	糹
縁	彐	糹	𧰨
縂	总	糹
縃	糹	胥
縄	日	电	糹
縅	威	糹
縆	恒	糹
縇	宣	糹
縈	糸	𤇾
縉	晋	糹
縊	益	糹
縋	糹	追
縌	糹	逆
縍	旁	糹
縎	糹	骨
縏	糸	般
縐	糹	芻
縑	兼	糹
縒	差	糹
縓	原	糹
縔	桑	糹
縕	糹	𥁕
縖	害	糹
縗	糹	衰
縘	奚	糹
縙	糹	茸
縚	糹	舀
縛	尃	糹
縜	員	糹
縝	真	糹
縞	糹	高
縟	糹	辱
縠	一	冖	士	殳	糸
縡	宰	糹
縢	月	絭
縣	一	且	小	系
縤	糹	素
縥	秦	糹
縦	従	糹
縧	條	糹
縨	晃	糹
縩	祭	糹
縪	畢	糹
縫	糹	逢
縬	戚	糹
縭	离	糹
縮	宿	糹
縯	寅	糹
縰	徙	糹
縱	從	糹
縲	糹	累
縳	專	糹
縴	牽	糹
縵	曼	糹
縶	執	糸
縷	婁	糹
縸	糹	莫
縹	票	糹
縺	糹	連
縻	糸	麻
縼	旋	糹
總	悤	糹
績	糹	責
縿	參	糹
繀	崔	糹
繁	敏	糸
繂	率	糹
繃	崩	糹
繄	殹	糸
繅	巢	糹
繆	糹	翏
繇	䍃	系
繈	強	糹
繉	兆	目	糹
繊	业	糹	𢦏
繋	糸	軗
繌	糹	𡕩
繍	粛	糹
繎	然	糹
繏	巽	糹
繐	惠	糹
繑	喬	糹
繒	曾	糹
繓	最	糹
織	戠	糹
繕	善	糹
繖	散	糹
繗	粦	糹
繘	矞	糹
繙	番	糹
繚	尞	糹
繛	卓	素
繜	尊	糹
繝	糹	閒
繞	堯	糹
繟	單	糹
繠	惢	糸
繡	糹	肅
繢	糹	貴
繣	畫	糹
繤	䋰	艹
繥	喜	糹
繦	强	糹
繧	糹	雲
繨	糹	達
繩	糹	黽
繪	會	糹
繫	糸	𣪠
繬	嗇	糹
繭	丨	冂	艹	𬗌
繮	畺	糹
繯	睘	糹
繰	喿	糹
繱	糹	葱
繲	糹	解
繳	敫	糹
繴	糸	辟
繵	亶	糹
繶	意	糹
繷	糹	農
繸	糹	遂
繹	睪	糹
繺	煞	糹
繻	糹	需
繼	㡭	糹
繽	糹	賓
繾	糹	遣
繿	監	糹
纀	僕	糹
纁	熏	糹
纂	糸	𮅕
纃	糹	齊
纄	糹	蓬
纅	樂	糹
纆	墨	糹
纇	米	糸	頁
纈	糹	頡
纉	糹	賛
纊	廣	糹
纋	憂	糹
續	糹	賣
纍	畾	糸
纎	糹	韯
纏	廛	糹
纐	糹	頝
纑	盧	糹
纒	㕓	糹
纓	嬰	糹
纔	毚	糹
纕	糹	襄
纖	糹	韱
纗	巂	糹
纘	糹	贊
纙	糹	羅
纚	糹	麗
纛	毒	縣
纜	糹	覽
纝	糹	纍
纞	戀	糹
纟	纟
纠	丩	纟
纡	于	纟
红	工	纟
纣	寸	纟
纤	千	纟
纥	乞	纟
约	勺	纟
级	及	纟
纨	丸	纟
纩	广	纟
纪	己	纟
纫	刃	纟
纬	纟	韦
纭	云	纟
纮	厷	纟
纯	屯	纟
纰	比	纟
纱	少	纟
纲	冈	纟
纳	内	纟
纴	壬	纟
纵	从	纟
纶	仑	纟
纷	分	纟
纸	氏	纟
纹	文	纟
纺	方	纟
纻	㝉	纟
纼	引	纟
纽	丑	纟
纾	予	纟
线	戋	纟
绀	甘	纟
绁	世	纟
绂	犮	纟
练	纟	𫠣
组	且	纟
绅	申	纟
细	田	纟
织	只	纟
终	冬	纟
绉	刍	纟
绊	半	纟
绋	弗	纟
绌	出	纟
绍	召	纟
绎	纟	𠬤
经	纟	𢀖
绐	台	纟
绑	纟	邦
绒	戎	纟
结	吉	纟
绔	夸	纟
绕	尧	纟
绖	纟	至
绗	纟	行
绘	会	纟
给	合	纟
绚	旬	纟
绛	夅	纟
络	各	纟
绝	纟	色
绞	交	纟
统	充	纟
绠	更	纟
绡	纟	肖
绢	纟	肙
绣	秀	纟
绤	纟	谷
绥	妥	纟
绦	条	纟
继	米	纟	𠃊
绨	弟	纟
绩	纟	责
绪	纟	者
绫	夌	纟
绬	纟	英
续	卖	纟
绮	奇	纟
绯	纟	非
绰	卓	纟
绱	尚	纟
绲	昆	纟
绳	纟	黾
维	纟	隹
绵	帛	纟
绶	受	纟
绷	朋	纟
绸	周	纟
绹	匋	纟
绺	咎	纟
绻	卷	纟
综	宗	纟
绽	定	纟
绾	官	纟
绿	录	纟
缀	叕	纟
缁	甾	纟
缂	纟	革
缃	相	纟
缄	咸	纟
缅	纟	面
缆	纟	览
缇	是	纟
缈	眇	纟
缉	咠	纟
缊	昷	纟
缋	纟	贵
缌	思	纟
缍	垂	纟
缎	段	纟
缏	便	纟
缐	泉	纟
缑	侯	纟
缒	纟	追
缓	爰	纟
缔	帝	纟
缕	娄	纟
编	扁	纟
缗	昬	纟
缘	彖	纟
缙	晋	纟
缚	尃	纟
缛	纟	辱
缜	真	纟
缝	纟	逢
缞	纟	衰
缟	纟	高
缠	㢆	纟
缡	离	纟
缢	益	纟
缣	兼	纟
缤	宾	纟
缥	票	纟
缦	曼	纟
缧	累	纟
缨	婴	纟
缩	宿	纟
缪	纟	翏
缫	巢	纟
缬	纟	颉
缭	尞	纟
缮	善	纟
缯	曾	纟
缰	畺	纟
缱	纟	遣
缲	喿	纟
缳	睘	纟
缴	敫	纟
缵	纟	赞
缶	缶
缷	卩	缶
缸	工	缶
缹	灬	缶
缺	夬	缶
缻	瓦	缶
缼	欠	缶
缽	本	缶
缾	并	缶
缿	后	缶
罀	兆	缶
罁	岡	缶
罂	缶	贝
罃	缶	𤇾
罄	殸	缶
罅	缶	虖
罆	缶	貫
罇	尊	缶
罈	缶	覃
罉	掌	缶
罊	缶	𣪠
罋	缶	雍
罌	缶	賏
罍	畾	缶
罎	曇	缶
罏	盧	缶
罐	缶	雚
网	㐅	冂
罒	罒
罓	㐅	冂
罔	冂	𠅇
罕	㓁	干
罖	亽	罒
罗	夕	罒
罘	不	罒
罙	㓁	木
罚	刂	罒	讠
罛	瓜	罒
罜	主	罒
罝	且	罒
罞	矛	罒
罟	古	罒
罠	民	罒
罡	正	罒
罢	去	罒
罣	圭	罒
罤	弟	罒
罥	罒	肙
罦	孚	罒
罧	林	罒
罨	奄	罒
罩	卓	罒
罪	罒	非
罫	卦	罒
罬	叕	罒
罭	或	罒
置	直	罒
罯	罒	音
罰	䚯	罒
罱	南	罒
署	罒	者
罳	思	罒
罴	灬	罢
罵	罒	馬
罶	留	罒
罷	罒	能
罸	罒	討
罹	惟	罒
罺	巢	罒
罻	尉	罒
罼	畢	罒
罽	剡	厂	罒
罾	曾	罒
罿	童	罒
羀	畱	网
羁	罒	革	马
羂	絹	罒
羃	幕	罒
羄	綽	罒
羅	維	罒
羆	熊	罒
羇	䩭	罒
羈	䩻	罒
羉	䜌	罒
羊	䒑	丨	二
羋	丨	二	卝
羌	乚	羊
羍	大	羊
美	大	𦍌
羏	彡	羊
羐	久	土	艹
羑	久	𦍌
羒	分	羊
羓	巴	羊
羔	灬	𦍌
羕	永	𦍌
羖	殳	羊
羗	厶	羌
羘	月	羊
羙	火	𦍌
羚	令	羊
羛	弗	𦍌
羜	宁	羊
羝	氐	羊
羞	丑	羊
羟	羊	𢀖
羠	夷	羊
羡	次	𦍌
羢	戎	羊
羣	君	羊
群	君	羊
羥	巠	羊
羦	完	羊
羧	夋	羊
羨	㳄	𦍌
義	我	𦍌
羪	羊	良
羫	空	羊
羬	咸	羊
羭	俞	羊
羮	一	夫	羔
羯	曷	羊
羰	炭	羊
羱	原	羊
羲	③	丂	禾	𦍌
羳	番	羊
羴	羊
羵	羊	賁
羶	亶	羊
羷	僉	羊
羸	凡	吂	月	羊
羹	美	羔
羺	羊	需
羻	慶	羊
羼	尸	羴
羽	习
羾	工	羽
羿	廾	羽
翀	中	羽
翁	公	羽
翂	分	羽
翃	厷	羽
翄	支	羽
翅	支	羽
翆	卆	羽
翇	犮	羽
翈	甲	羽
翉	本	羽
翊	立	羽
翋	立	羽
翌	立	羽
翍	皮	羽
翎	令	羽
翏	㐱	羽
翐	失	羽
翑	句	羽
習	白	羽
翓	吉	羽
翔	羊	羽
翕	合	羽
翖	合	羽
翗	多	羽
翘	尧	羽
翙	岁	羽
翚	军	羽
翛	丨	亻	夂	羽
翜	夾	羽
翝	宏	羽
翞	京	羽
翟	羽	隹
翠	卒	羽
翡	羽	非
翢	周	羽
翣	妾	羽
翤	口	羽	𠕁
翥	羽	者
翦	前	羽
翧	宣	羽
翨	是	羽
翩	扁	羽
翪	㚇	羽
翫	元	習
翬	羽	軍
翭	侯	羽
翮	羽	鬲
翯	羽	高
翰	人	羽	𠦝
翱	皋	羽
翲	票	羽
翳	殹	羽
翴	羽	連
翵	羽	鳥
翶	皐	羽
翷	粦	羽
翸	羽	賁
翹	堯	羽
翺	羽	臯
翻	番	羽
翼	異	羽
翽	歲	羽
翾	睘	羽
翿	壽	羽
耀	光	翟
老	匕	耂
耂	耂
考	丂	耂
耄	毛	老
者	日	耂
耆	日	老
耇	句	耂
耈	句	老
耉	口	考
耊	耂	至
耋	老	至
而	一	𦓐
耍	女	而
耎	大	而
耏	彡	而
耐	寸	而
耑	山	而
耒	一	未
耓	丁	耒
耔	子	耒
耕	井	耒
耖	少	耒
耗	毛	耒
耘	云	耒
耙	巴	耒
耚	皮	耒
耛	台	耒
耜	㠯	耒
耝	且	耒
耞	加	耒
耟	巨	耒
耠	合	耒
耡	助	耒
耢	劳	耒
耣	侖	耒
耤	昔	耒
耥	尚	耒
耦	禺	耒
耧	娄	耒
耨	耒	辱
耩	冓	耒
耪	旁	耒
耫	耒	責
耬	婁	耒
耭	幾	耒
耮	勞	耒
耯	耒	蒦
耰	憂	耒
耱	磨	耒
耲	耒	褱
耳	耳
耴	乚	耳
耵	丁	耳
耶	耳	阝
耷	大	耳
耸	从	耳
耹	今	耳
耺	云	耳
耻	止	耳
耼	冄	耳
耽	冘	耳
耾	厷	耳
耿	火	耳
聀	戈	耳
聁	分	耳
聂	双	耳
聃	冉	耳
聄	㐱	耳
聅	矢	耳
聆	令	耳
聇	正	耳
聈	幼	耳
聉	出	耳
聊	卯	耳
聋	耳	龙
职	只	耳
聍	宁	耳
聎	兆	耳
聏	而	耳
聐	吉	耳
聑	耳
聒	耳	舌
聓	巩	耳
联	关	耳
聕	告	耳
聖	王	𦔻
聗	夾	耳
聘	甹	耳
聙	耳	青
聚	乑	取
聛	卑	耳
聜	空	耳
聝	或	耳
聞	耳	門
聟	知	耳
聠	并	耳
聡	忩	耳
聢	定	耳
聣	兒	耳
聤	亭	耳
聥	禹	耳
聦	怱	耳
聧	癸	耳
聨	耳	𢇂
聩	耳	贵
聪	总	耳
聫	大	耳	𢆶
聬	翁	耳
聭	耳	鬼
聮	耳	𢇁
聯	耳	𢇇
聰	悤	耳
聱	敖	耳
聲	殸	耳
聳	從	耳
聴	十	心	罒	耳
聵	耳	貴
聶	耳	聑
職	戠	耳
聸	耳	詹
聹	寧	耳
聺	察	耳
聻	漸	耳
聼	乛	耳	𢛳
聽	壬	耳	𢛳
聾	耳	龍
聿	二	肀
肀	コ	一	丨
肁	户	聿
肂	歹	聿
肃	肃
肄	聿	𠤕
肅	肅
肆	聿	镸
肇	聿	𢼄
肈	聿	𫼉
肉	肉
肊	乙	月
肋	力	月
肌	几	月
肍	九	月
肎	冖	月
肏	入	肉
肐	乞	月
肑	勺	月
肒	丸	月
肓	亡	月
肔	也	月
肕	刃	月
肖	⺌	月
肗	女	月
肘	寸	月
肙	口	月
肚	土	月
肛	工	月
肜	彡	月
肝	干	月
肞	义	月
肟	亏	月
肠	月	𠃓
股	月	殳
肢	支	月
肣	今	月
肤	夫	月
肥	巴	月
肦	⺼	分
肧	不	月
肨	丰	月
肩	户	月
肪	方	月
肫	屯	月
肬	尤	月
肭	内	月
肮	亢	月
肯	月	止
肰	月	犬
肱	厷	月
育	月	𠫓
肳	勿	月
肴	㐅	有
肵	斤	月
肶	月	比
肷	月	欠
肸	八	十	月
肹	兮	月
肺	巿	月
肻	⺊	肎
肼	井	月
肽	太	月
肾	〢	又	月
肿	中	月
胀	月	长
胁	办	月
胂	月	申
胃	月	田
胄	月	由
胅	失	月
胆	旦	月
胇	弗	月
胈	月	犮
胉	月	白
胊	句	月
胋	占	月
背	北	月
胍	月	瓜
胎	台	月
胏	月	𠂔
胐	出	月
胑	只	月
胒	尼	月
胓	平	月
胔	此	肉
胕	付	月
胖	半	月
胗	㐱	月
胘	月	玄
胙	乍	月
胚	丕	月
胛	月	甲
胜	月	生
胝	月	氐
胞	包	月
胟	月	母
胠	去	月
胡	古	月
胢	可	月
胣	㐌	月
胤	丿	乚	幺	月
胥	月	疋
胦	央	月
胧	月	龙
胨	东	月
胩	卡	月
胪	卢	月
胫	月	𢀖
胬	奴	肉
胭	因	月
胮	夅	月
胯	夸	月
胰	夷	月
胱	光	月
胲	亥	月
胳	各	月
胴	同	月
胵	月	至
胶	交	月
胷	匈	月
胸	匈	月
胹	月	而
胺	安	月
胻	月	行
胼	并	月
能	䏍	𫧇
胾	肉	𢦏
胿	圭	月
脀	丞	月
脁	兆	月
脂	旨	月
脃	月	色
脄	月	灰
脅	劦	月
脆	危	月
脇	劦	月
脈	月	𠂢
脉	月	永
脊	丷	人	八	月
脋	刕	月
脌	年	月
脍	会	月
脎	月	杀
脏	庄	月
脐	月	齐
脑	㐫	月
脒	月	米
脓	农	月
脔	亦	肉
脕	免	月
脖	孛	月
脗	月	𠯳
脘	完	月
脙	月	求
脚	却	月
脛	巠	月
脜	月	𦣻
脝	亨	月
脞	坐	月
脟	寽	月
脠	延	月
脡	廷	月
脢	月	每
脣	月	辰
脤	月	辰
脥	夾	月
脦	忒	月
脧	夋	月
脨	月	束
脩	丨	亻	𡕙
脪	希	月
脫	兌	月
脬	孚	月
脭	呈	月
脮	妥	月
脯	月	甫
脰	月	豆
脱	兑	月
脲	尿	月
脳	凶	月	𭕄
脴	否	月
脵	吴	月
脶	呙	月
脷	利	月
脸	佥	月
脹	月	長
脺	卒	月
脻	月	疌
脼	兩	月
脽	月	隹
脾	卑	月
脿	月	表
腀	侖	月
腁	幷	月
腂	月	果
腃	卷	月
腄	垂	月
腅	月	炎
腆	典	月
腇	委	月
腈	月	青
腉	兒	月
腊	昔	月
腋	夜	月
腌	奄	月
腍	念	月
腎	月	臤
腏	叕	月
腐	府	肉
腑	府	月
腒	居	月
腓	月	非
腔	月	空
腕	宛	月
腖	月	東
腗	月	畁
腘	国	月
腙	宗	月
腚	定	月
腛	屋	月
腜	月	某
腝	月	耎
腞	彖	月
腟	室	月
腠	奏	月
腡	咼	月
腢	月	禺
腣	帝	月
腤	月	音
腥	星	月
腦	月	𡿺
腧	俞	月
腨	月	耑
腩	南	月
腪	月	軍
腫	月	重
腬	月	柔
腭	咢	月
腮	思	月
腯	月	盾
腰	月	要
腱	建	月
腲	月	畏
腳	卻	月
腴	月	臾
腵	叚	月
腶	月	段
腷	月	畐
腸	昜	月
腹	复	月
腺	月	泉
腻	月	贰
腼	月	面
腽	昷	月
腾	月	马	龹
腿	月	退
膀	旁	月
膁	兼	月
膂	旅	月
膃	月	𥁕
膄	叟	月
膅	唐	月
膆	月	素
膇	月	追
膈	月	鬲
膉	月	益
膊	尃	月
膋	月	𤇾
膌	月	脊
膍	月	𣬉
膎	奚	月
膏	月	高
膐	旅	肉
膑	宾	月
膒	區	月
膓	月	𬀷
膔	月	鹿
膕	國	月
膖	月	逢
膗	崔	月
膘	月	票
膙	强	月
膚	胃	虍
膛	堂	月
膜	月	莫
膝	月	桼
膞	專	月
膟	月	率
膠	月	翏
膡	月	眷
膢	婁	月
膣	月	窒
膤	月	雪
膥	成	末	肉
膦	月	粦
膧	月	童
膨	彭	月
膩	月	貳
膪	啻	月
膫	尞	月
膬	月	毳
膭	月	貴
膮	堯	月
膯	月	登
膰	月	番
膱	戠	月
膲	月	焦
膳	善	月
膴	月	無
膵	月	萃
膶	月	閏
膷	月	鄉
膸	月	遀
膹	月	賁
膺	䧹	月
膻	亶	月
膼	月	過
膽	月	詹
膾	會	月
膿	月	農
臀	月	殿
臁	廉	月
臂	月	辟
臃	月	雍
臄	月	豦
臅	月	蜀
臆	意	月
臇	月	雋
臈	月	葛
臉	僉	月
臊	喿	月
臋	殿	肉
臌	月	鼓
臍	月	齊
臎	月	翠
臏	月	賓
臐	月	熏
臑	月	需
臒	月	蒦
臓	月	蔵
臔	月	賢
臕	月	麃
臖	月	興
臗	寬	月
臘	巤	月
臙	月	燕
臚	月	盧
臛	月	霍
臜	月	赞
臝	凡	吂	月	果
臞	月	瞿
臟	月	藏
臠	䜌	肉
臡	肉	難
臢	月	贊
臣	臣
臤	又	臣
臥	人	臣
臦	⑥	臣
臧	戕	臣
臨	品	臣	𠂉
臩	夰	臦
自	自
臫	乚	自
臬	木	自
臭	犬	自
臮	人	亻	自
臯	自	𠦂
臰	死	自
臱	方	穴	自
臲	危	臬
至	土	𠫔
致	攵	至
臵	各	至
臶	存	至
臷	至	𢦏
臸	至
臹	成	至
臺	冖	吉	至
臻	秦	至
臼	臼
臽	勹	臼
臾	人	臼
臿	千	臼
舀	爫	臼
舁	廾	臼
舂	臼	𡗗
舃	②	灬	臼
舄	勹	灬	臼
舅	男	臼
舆	一	八	车	𦥑
與	②	一	丿	八	𦥑
興	一	八	同	𦥑
舉	丨	二	與
舊	臼	萑
舋	且	冖	同	𦥑
舌	千	口
舍	人	舌
舎	人	𠮷
舏	丩	舌
舐	氏	舌
舑	冉	舌
舒	予	舍
舓	易	舌
舔	忝	舌
舕	炎	舌
舖	甫	舍
舗	甫	舎
舘	官	舍
舙	舌	𦧚
舚	舌	詹
舛	㐄	夕
舜	冖	爫	舛
舝	㐄	冖	厶	巛	𫝀
舞	一	卌	舛	𠂉
舟	舟
舠	刀	舟
舡	工	舟
舢	山	舟
舣	义	舟
舤	凡	舟
舥	巴	舟
舦	太	舟
舧	舟	𭂫
舨	反	舟
舩	公	舟
航	亢	舟
舫	方	舟
般	殳	舟
舭	比	舟
舮	户	舟
舯	中	舟
舰	舟	见
舱	仓	舟
舲	令	舟
舳	由	舟
舴	乍	舟
舵	它	舟
舶	白	舟
舷	玄	舟
舸	可	舟
船	口	舟	𠘧
舺	甲	舟
舻	卢	舟
舼	共	舟
舽	夅	舟
舾	舟	西
舿	夸	舟
艀	孚	舟
艁	告	舟
艂	夆	舟
艃	舟	里
艄	肖	舟
艅	余	舟
艆	舟	良
艇	廷	舟
艈	㐬	舟
艉	尾	舟
艊	帛	舟
艋	孟	舟
艌	念	舟
艍	居	舟
艎	皇	舟
艏	舟	首
艐	㚇	舟
艑	扁	舟
艒	冒	舟
艓	枼	舟
艔	度	舟
艕	旁	舟
艖	差	舟
艗	益	舟
艘	叟	舟
艙	倉	舟
艚	曹	舟
艛	婁	舟
艜	帶	舟
艝	舟	雪
艞	筄	舟
艟	童	舟
艠	登	舟
艡	當	舟
艢	嗇	舟
艣	舟	虜
艤	義	舟
艥	戢	舟
艦	監	舟
艧	舟	蒦
艨	舟	蒙
艩	舟	齊
艪	舟	魯
艫	盧	舟
艬	毚	舟
艭	舟	雙
艮	艮
良	丶	艮
艰	又	艮
艱	口	夫	廿	艮
色	巴	𠂊
艳	丰	色
艴	弗	色
艵	并	色
艶	色	豊
艷	色	豐
艸	屮
艹	丨	十
艺	乙	艹
艻	力	艹
艼	丁	艹
艽	九	艹
艾	乂	艹
艿	乃	艹
芀	刀	艹
芁	几	艹
节	丨	艹	𠃌
芃	凡	艹
芄	丸	艹
芅	弋	艹
芆	叉	艹
芇	巾	艹
芈	丨	二	艹
芉	干	艹
芊	千	艹
芋	于	艹
芌	亏	艹
芍	勺	艹
芎	弓	艹
芏	土	艹
芐	下	艹
芑	己	艹
芒	亡	艹
芓	子	艹
芔	屮	艸
芕	夕	艹
芖	大	艹
芗	乡	艹
芘	比	艹
芙	夫	艹
芚	屯	艹
芛	尹	艹
芜	无	艹
芝	之	艹
芞	气	艹
芟	殳	艹
芠	文	艹
芡	欠	艹
芢	仁	艹
芣	不	艹
芤	孔	艹
芥	介	艹
芦	户	艹
芧	予	艹
芨	及	艹
芩	今	艹
芪	氏	艹
芫	元	艹
芬	分	艹
芭	巴	艹
芮	内	艹
芯	心	艹
芰	支	艹
花	化	艹
芲	人	艹	𠤎
芳	方	艹
芴	勿	艹
芵	夬	艹
芶	勾	艹
芷	止	艹
芸	云	艹
芹	斤	艹
芺	夭	艹
芻	勹	屮
芼	毛	艹
芽	牙	艹
芾	巿	艹
芿	仍	艹
苀	亢	艹
苁	从	艹
苂	火	艹
苃	友	艹
苄	卞	艹
苅	刈	艹
苆	切	艹
苇	艹	韦
苈	历	艹
苉	匹	艹
苊	厄	艹
苋	艹	见
苌	艹	长
苍	仓	艹
苎	㝉	艹
苏	办	艹
苐	艹	𢎨
苑	夗	艹
苒	冉	艹
苓	令	艹
苔	台	艹
苕	召	艹
苖	由	艹
苗	田	艹
苘	冋	艹
苙	立	艹
苚	用	艹
苛	可	艹
苜	目	艹
苝	北	艹
苞	包	艹
苟	句	艹
苠	民	艹
苡	以	艹
苢	㠯	艹
苣	巨	艹
苤	丕	艹
若	右	艹
苦	古	艹
苧	宁	艹
苨	尼	艹
苩	白	艹
苪	丙	艹
苫	占	艹
苬	囚	艹
苭	幼	艹
苮	仙	艹
苯	本	艹
苰	弘	艹
英	央	艹
苲	乍	艹
苳	冬	艹
苴	且	艹
苵	失	艹
苶	尒	艹
苷	甘	艹
苸	乎	艹
苹	平	艹
苺	母	艹
苻	付	艹
苼	生	艹
苽	瓜	艹
苾	必	艹
苿	未	艹
茀	弗	艹
茁	出	艹
茂	戊	艹
范	氾	艹
茄	加	艹
茅	矛	艹
茆	卯	艹
茇	犮	艹
茈	此	艹
茉	末	艹
茊	丘	艹
茋	氐	艹
茌	仕	艹
茍	句	艹
茎	艹	𢀖
茏	艹	龙
茐	匆	艹
茑	艹	鸟
茒	艹	邜
茓	穴	艹
茔	土	𫇦
茕	卂	𫇦
茖	各	艹
茗	名	艹
茘	刕	艹
茙	戎	艹
茚	印	艹
茛	艮	艹
茜	艹	西
茝	艹	𦣞
茞	臣	艹
茟	聿	艹
茠	休	艹
茡	字	艹
茢	列	艹
茣	吴	艹
茤	多	艹
茥	圭	艹
茦	朿	艹
茧	艹	虫
茨	次	艹
茩	后	艹
茪	光	艹
茫	汒	艹
茬	在	艹
茭	交	艹
茮	尗	艹
茯	伏	艹
茰	乂	日	艹
茱	朱	艹
茲	艹	𢆶
茳	江	艹
茴	回	艹
茵	因	艹
茶	人	朩	艹
茷	伐	艹
茸	耳	艹
茹	如	艹
茺	充	艹
茻	艸
茼	同	艹
茽	仲	艹
茾	开	艹
茿	巩	艹
荀	旬	艹
荁	亘	艹
荂	夸	艹
荃	全	艹
荄	亥	艹
荅	合	艹
荆	刂	茾
荇	艹	行
荈	舛	艹
草	早	艹
荊	刑	艹
荋	而	艹
荌	安	艹
荍	收	艹
荎	至	艹
荏	任	艹
荐	存	艹
荑	夷	艹
荒	巟	艹
荓	并	艹
荔	劦	艹
荕	肋	艹
荖	老	艹
荗	戍	艹
荘	壮	艹
荙	艹	达
荚	夹	艹
荛	尧	艹
荜	毕	艹
荝	则	艹
荞	乔	艹
荟	会	艹
荠	艹	齐
荡	汤	艹
荢	宇	艹
荣	艹	𣎾
荤	军	艹
荥	艹	𠕽
荦	牛	𫇦
荧	火	𫇦
荨	寻	艹
荩	尽	艹
荪	孙	艹
荫	艹	阴
荬	买	艹
荭	红	艹
荮	纣	艹
药	约	艹
荰	杜	艹
荱	尾	艹
荲	艹	里
荳	艹	豆
荴	扶	艹
荵	忍	艹
荶	吟	艹
荷	何	艹
荸	孛	艹
荹	步	艹
荺	均	艹
荻	狄	艹
荼	余	艹
荽	妥	艹
荾	夋	艹
荿	成	艹
莀	艹	辰
莁	巫	艹
莂	别	艹
莃	希	艹
莄	更	艹
莅	位	艹
莆	甫	艹
莇	助	艹
莈	没	艹
莉	利	艹
莊	壯	艹
莋	作	艹
莌	兑	艹
莍	求	艹
莎	沙	艹
莏	抄	艹
莐	沈	艹
莑	夆	艹
莒	吕	艹
莓	每	艹
莔	囧	艹
莕	杏	艹
莖	巠	艹
莗	艹	車
莘	艹	辛
莙	君	艹
莚	延	艹
莛	廷	艹
莜	攸	艹
莝	坐	艹
莞	完	艹
莟	含	艹
莠	秀	艹
莡	艹	足
莢	夾	艹
莣	忘	艹
莤	艹	酉
莥	狃	艹
莦	肖	艹
莧	艹	見
莨	良	艹
莩	孚	艹
莪	我	艹
莫	旲	艹
莬	免	艹
莭	即	艹
莮	男	艹
莯	沐	艹
莰	坎	艹
莱	来	艹
莲	艹	连
莳	时	艹
莴	呙	艹
莵	⑤	丶	丿	艹
莶	佥	艹
获	犾	艹
莸	犹	艹
莹	玉	𫇦
莺	鸟	𫇦
莻	叱	艿
莼	纯	艹
莽	廾	𦬫
莾	奔	艹
莿	刺	艹
菀	宛	艹
菁	艹	青
菂	的	艹
菃	洰	艹
菄	東	艹
菅	官	艹
菆	取	艹
菇	姑	艹
菈	拉	艹
菉	录	艹
菊	匊	艹
菋	味	艹
菌	囷	艹
菍	念	艹
菎	昆	艹
菏	河	艹
菐	䒑	业	夫
菑	甾	艹
菒	杲	艹
菓	果	艹
菔	服	艹
菕	侖	艹
菖	昌	艹
菗	抽	艹
菘	松	艹
菙	垂	艹
菚	戔	艹
菛	艹	門
菜	艹	采
菝	拔	艹
菞	艹	𥝢
菟	兔	艹
菠	波	艹
菡	函	艹
菢	抱	艹
菣	臤	艹
菤	卷	艹
菥	析	艹
菦	艹	近
菧	底	艹
菨	妾	艹
菩	咅	艹
菪	宕	艹
菫	一	口	艹	龶
菬	沼	艹
菭	治	艹
菮	庚	艹
華	⑦	艹
菰	孤	艹
菱	夌	艹
菲	艹	非
菳	艹	金
菴	奄	艹
菵	罔	艹
菶	奉	艹
菷	帚	艹
菸	於	艹
菹	沮	艹
菺	肩	艹
菻	林	艹
菼	炎	艹
菽	叔	艹
菾	忝	艹
菿	到	艹
萀	艹	虎
萁	其	艹
萂	和	艹
萃	卒	艹
萄	匋	艹
萅	旾	艹
萆	卑	艹
萇	艹	長
萈	丶	艹	見
萉	肥	艹
萊	來	艹
萋	妻	艹
萌	明	艹
萍	泙	艹
萎	委	艹
萏	臽	艹
萐	疌	艹
萑	艹	隹
萒	兖	艹
萓	宜	艹
萔	招	艹
萕	斉	艹
萖	兒	艹
萗	宗	艹
萘	奈	艹
萙	枕	艹
萚	择	艹
萛	艹	𥃲
萜	帖	艹
萝	罗	艹
萞	比	艹	𠔿
萟	秇	艹
萠	朋	艹
萡	泊	艹
萢	泡	艹
萣	定	艹
萤	虫	𫇦
营	吕	𫇦
萦	糸	𫇦
萧	肃	艹
萨	产	艹	阝
萩	秋	艹
萪	科	艹
萫	艹	香
萬	禺	艹
萭	禹	艹
萮	俞	艹
萯	艹	負
萰	柬	艹
萱	宣	艹
萲	爰	艹
萳	南	艹
萴	則	艹
萵	咼	艹
萶	春	艹
萷	削	艹
萸	臾	艹
萹	扁	艹
萺	冒	艹
萻	艹	音
萼	咢	艹
落	洛	艹
萾	盈	艹
萿	活	艹
葀	括	艹
葁	姜	艹
葂	勉	艹
葃	昨	艹
葄	胙	艹
葅	俎	艹
葆	保	艹
葇	柔	艹
葈	枲	艹
葉	枼	艹
葊	弇	艹
葋	朐	艹
葌	姦	艹
葍	畐	艹
葎	律	艹
葏	津	艹
葐	盆	艹
葑	封	艹
葒	紅	艹
葓	洪	艹
葔	侯	艹
葕	艹	衍
葖	突	艹
著	者	艹
葘	艹	甾
葙	相	艹
葚	甚	艹
葛	曷	艹
葜	契	艹
葝	勁	艹
葞	弭	艹
葟	皇	艹
葠	侵	艹
葡	匍	艹
葢	盇	艹
董	艹	重
葤	紂	艹
葥	前	艹
葦	艹	韋
葧	勃	艹
葨	畏	艹
葩	皅	艹
葪	㓩	艹
葫	胡	艹
葬	廾	死	艹
葭	叚	艹
葮	段	艹
葯	約	艹
葰	俊	艹
葱	怱	艹
葲	泉	艹
葳	威	艹
葴	咸	艹
葵	癸	艹
葶	亭	艹
葷	艹	軍
葸	思	艹
葹	施	艹
葺	咠	艹
葻	艹	風
葼	㚇	艹
葽	艹	要
葾	怨	艹
葿	眉	艹
蒀	昷	艹
蒁	艹	述
蒂	帝	艹
蒃	彖	艹
蒄	冠	艹
蒅	染	艹
蒆	女	巩	艹
蒇	戊	艹	贝
蒈	皆	艹
蒉	艹	贵
蒊	叱	花
蒋	将	艹
蒌	娄	艹
蒍	為	艹
蒎	派	艹
蒏	酉	𫇦
蒐	艹	鬼
蒑	殷	艹
蒒	師	艹
蒓	純	艹
蒔	時	艹
蒕	艹	𥁕
蒖	真	艹
蒗	浪	艹
蒘	挐	艹
蒙	冡	艹
蒚	艹	鬲
蒛	缺	艹
蒜	祘	艹
蒝	原	艹
蒞	涖	艹
蒟	竘	艹
蒠	息	艹
蒡	旁	艹
蒢	艹	除
蒣	徐	艹
蒤	涂	艹
蒥	留	艹
蒦	艹	隻
蒧	占	茂
蒨	倩	艹
蒩	租	艹
蒪	尃	艹
蒫	差	艹
蒬	冤	艹
蒭	艹	芻
蒮	艹	隺
蒯	刂	萠
蒰	般	艹
蒱	捕	艹
蒲	浦	艹
蒳	納	艹
蒴	朔	艹
蒵	奚	艹
蒶	紛	艹
蒷	員	艹
蒸	烝	艹
蒹	兼	艹
蒺	疾	艹
蒻	弱	艹
蒼	倉	艹
蒽	恩	艹
蒾	艹	迷
蒿	艹	高
蓀	孫	艹
蓁	秦	艹
蓂	冥	艹
蓃	叟	艹
蓄	畜	艹
蓅	流	艹
蓆	席	艹
蓇	艹	骨
蓈	艹	郎
蓉	容	艹
蓊	翁	艹
蓋	盍	艹
蓌	夎	艹
蓍	耆	艹
蓎	唐	艹
蓏	㼌	艹
蓐	艹	辱
蓑	艹	衰
蓒	艹	軒
蓓	倍	艹
蓔	羔	艹
蓕	桂	艹
蓖	艹	𣬉
蓗	徒	艹
蓘	艹	衮
蓙	座	艹
蓚	修	艹
蓛	敇	艹
蓜	艹	配
蓝	监	艹
蓞	舀	艹
蓟	艹	𬶀
蓠	离	艹
蓡	浸	艹
蓢	朗	艹
蓣	艹	预
蓤	凌	艹
蓥	金	𫇦
蓦	莫	马
蓧	條	艹
蓨	脩	艹
蓩	務	艹
蓪	艹	通
蓫	艹	逐
蓬	艹	逢
蓭	庵	艹
蓮	艹	連
蓯	從	艹
蓰	徙	艹
蓱	洴	艹
蓲	區	艹
蓳	堇	艹
蓴	專	艹
蓵	捷	艹
蓶	唯	艹
蓷	推	艹
蓸	曹	艹
蓹	御	艹
蓺	埶	艹
蓻	執	艹
蓼	翏	艹
蓽	畢	艹
蓾	艹	鹵
蓿	宿	艹
蔀	艹	部
蔁	章	艹
蔂	累	艹
蔃	强	艹
蔄	問	艹
蔅	艹	𨳐
蔆	淩	艹
蔇	既	艹
蔈	票	艹
蔉	艹	袞
蔊	焊	艹
蔋	淑	艹
蔌	欶	艹
蔍	艹	鹿
蔎	艹	設
蔏	商	艹
蔐	啇	艹
蔑	戍	𦭝
蔒	焄	艹
蔓	曼	艹
蔔	匐	艹
蔕	帶	艹
蔖	艹	虘
蔗	庶	艹
蔘	參	艹
蔙	旋	艹
蔚	尉	艹
蔛	斛	艹
蔜	敖	艹
蔝	眯	艹
蔞	婁	艹
蔟	族	艹
蔠	終	艹
蔡	祭	艹
蔢	婆	艹
蔣	將	艹
蔤	密	艹
蔥	悤	艹
蔦	艹	鳥
蔧	彗	艹
蔨	圈	艹
蔩	寅	艹
蔪	斬	艹
蔫	焉	艹
蔬	疏	艹
蔭	艹	陰
蔮	國	艹
蔯	艹	陳
蔰	扈	艹
蔱	殺	艹
蔲	艹	𡨥
蔳	清	艹
蔴	艹	麻
蔵	艹	𮍏
蔶	艹	責
蔷	啬	艹
蔸	兜	艹
蔹	敛	艹
蔺	艹	𫔴
蔻	寇	艹
蔼	艹	谒
蔽	敝	艹
蔾	棃	艹
蔿	爲	艹
蕀	棘	艹
蕁	尋	艹
蕂	勝	艹
蕃	番	艹
蕄	悶	艹
蕅	湡	艹
蕆	戊	艹	貝
蕇	單	艹
蕈	艹	覃
蕉	焦	艹
蕊	惢	艹
蕋	歮	艹
蕌	晶	艹
蕍	渝	艹
蕎	喬	艹
蕏	猪	艹
蕐	一	丨	二	艹	𠈌
蕑	艹	閒
蕒	艹	買
蕓	艹	雲
蕔	報	艹
蕕	猶	艹
蕖	渠	艹
蕗	艹	路
蕘	堯	艹
蕙	惠	艹
蕚	亏	品	艹
蕛	稊	艹
蕜	悲	艹
蕝	絶	艹
蕞	最	艹
蕟	發	艹
蕠	絮	艹
蕡	艹	賁
蕢	艹	貴
蕣	舜	艹
蕤	甤	艹
蕥	艹	雅
蕦	艹	須
蕧	復	艹
蕨	厥	艹
蕩	湯	艹
蕪	無	艹
蕫	童	艹
蕬	絲	艹
蕭	肅	艹
蕮	舄	艹
蕯	艹	隆
蕰	温	艹
蕱	稍	艹
蕲	单	斤	艹
蕳	艹	間
蕴	缊	艹
蕵	艹	飧
蕶	艹	零
蕷	艹	預
蕸	艹	遐
蕹	艹	雍
蕺	戢	艹
蕻	共	艹	镸
蕼	肆	艹
蕽	艹	農
蕾	艹	雷
蕿	煖	艹
薀	溫	艹
薁	奥	艹
薂	敫	艹
薃	滈	艹
薄	溥	艹
薅	媷	艹
薆	愛	艹
薇	微	艹
薈	會	艹
薉	歲	艹
薊	艹	魝
薋	艹	資
薌	艹	鄉
薍	亂	艹
薎	伐	冖	罒	艹
薏	意	艹
薐	稜	艹
薑	畺	艹
薒	粲	艹
薓	艹	𣹰
薔	嗇	艹
薕	廉	艹
薖	艹	過
薗	園	艹
薘	艹	達
薙	艹	雉
薚	昜	歹	艹
薛	艹	辛	𠂤
薜	艹	辟
薝	艹	詹
薞	艹	飱
薟	僉	艹
薠	煩	艹
薡	艹	鼎
薢	艹	解
薣	艹	鼓
薤	艹	𩐁
薥	艹	蜀
薦	廌	艹
薧	艹	𣨻
薨	冖	死	罒	艹
薩	艹	隡
薪	新	艹
薫	艹	𤋱
薬	楽	艹
薭	稗	艹
薮	数	艹
薯	署	艹
薰	熏	艹
薱	對	艹
薲	艹	賓
薳	艹	遠
薴	寧	艹
薵	壽	艹
薶	艹	貍
薷	艹	需
薸	漂	艹
薹	臺	艹
薺	艹	齊
薻	漅	艹
薼	塵	艹
薽	甄	艹
薾	爾	艹
薿	疑	艹
藀	熒	艹
藁	槀	艹
藂	聚	艹
藃	歊	艹
藄	綦	艹
藅	罰	艹
藆	搴	艹
藇	與	艹
藈	睽	艹
藉	耤	艹
藊	稨	艹
藋	翟	艹
藌	艹	蜜
藍	監	艹
藎	盡	艹
藏	臧	艹
藐	艹	貌
藑	夐	艹
藒	䅥	艹
藓	艹	鲜
藔	寮	艹
藕	耦	艹
藖	艹	賢
藗	艹	遬
藘	慮	艹
藙	毅	艹
藚	艹	賣
藛	寫	艹
藜	艹	黎
藝	云	蓺
藞	磊	艹
藟	畾	艹
藠	皛	艹
藡	艹	適
藢	徵	艹
藣	罷	艹
藤	滕	艹
藥	樂	艹
藦	摩	艹
藧	緩	艹
藨	艹	麃
藩	潘	艹
藪	數	艹
藫	潭	艹
藬	艹	隤
藭	窮	艹
藮	樵	艹
藯	慰	艹
藰	劉	艹
藱	瘣	艹
藲	樞	艹
藳	稾	艹
藴	緼	艹
藵	艹	𧛱
藶	歷	艹
藷	艹	諸
藸	艹	豬
藹	艹	謁
藺	艹	閵
藻	澡	艹
藼	憲	艹
藽	艹	親
藾	艹	賴
藿	艹	霍
蘀	擇	艹
蘁	噩	艹
蘂	橤	艹
蘃	木	歮	艹
蘄	單	斤	艹
蘅	艹	衡
蘆	盧	艹
蘇	穌	艹
蘈	艹	頽
蘉	侵	冖	𦭝
蘊	縕	艹
蘋	艹	頻
蘌	禦	艹
蘍	勳	艹
蘎	肥	𦲸
蘏	艹	頴
蘐	艹	諼
蘑	磨	艹
蘒	穐	艹
蘓	艹	𮃣
蘔	穎	艹
蘕	縫	艹
蘖	木	薛
蘗	檗	艹
蘘	艹	襄
蘙	翳	艹
蘚	艹	鮮
蘛	甚	育	艹
蘜	艹	鞠
蘝	歛	艹
蘞	斂	艹
蘟	艹	隱
蘠	牆	艹
蘡	嬰	艹
蘢	艹	龍
蘣	艹	黈
蘤	艹	𤾡
蘥	艹	龠
蘦	艹	霝
蘧	艹	遽
蘨	繇	艹
蘩	繁	艹
蘪	艹	麋
蘫	濫	艹
蘬	歸	艹
蘭	艹	闌
蘮	罽	艹
蘯	盪	艹
蘰	縵	艹
蘱	艹	類
蘲	壘	艹
蘳	艹	黊
蘴	艹	豐
蘵	職	艹
蘶	艹	魏
蘷	一	八	夂	巳	止	白	艹
蘸	艹	醮
蘹	懷	艹
蘺	艹	離
蘻	繫	艹
蘼	艹	靡
蘽	櫐	艹
蘾	壞	艹
蘿	羅	艹
虀	艹	韲
虁	夔	艹
虂	艹	露
虃	瀸	艹
虄	夂	産	艹	虫
虅	艹	騰
虆	纍	艹
虇	艹	𢑆
虈	嚻	艹
虉	艹	鷊
虊	欒	艹
虋	艹	釁
虌	艹	鼈
虍	②	⺊	七
虎	几	虍
虏	力	虍
虐	一	匚	虍
虑	心	虍
虒	虎	𠂆
虓	九	虎
虔	文	虍
處	処	虍
虖	乎	虍
虗	丘	虍
虘	且	虍
虙	必	虍
虚	业	虍
虛	⑥	虍
虜	男	虍
虝	勿	虎
虞	吴	虍
號	号	虎
虠	交	虎
虡	八	虚
虢	寽	虎
虣	武	虎
虤	虎
虥	戔	虎
虦	戔	虎
虧	亏	雐
虨	彡	𧇃
虩	虎	𡭴
虪	儵	虎
虫	虫
虬	乚	虫
虭	刀	虫
虮	几	虫
虯	丩	虫
虰	丁	虫
虱	⺄	䖝
虲	卜	虫
虳	勺	虫
虴	乇	虫
虵	也	虫
虶	于	虫
虷	干	虫
虸	子	虫
虹	工	虫
虺	兀	虫
虻	亡	虫
虼	乞	虫
虽	口	虫
虾	下	虫
虿	万	虫
蚀	虫	饣
蚁	义	虫
蚂	虫	马
蚃	乡	虫
蚄	方	虫
蚅	厄	虫
蚆	巴	虫
蚇	尺	虫
蚈	开	虫
蚉	文	虫
蚊	文	虫
蚋	内	虫
蚌	丰	虫
蚍	比	虫
蚎	日	虫
蚏	月	虫
蚐	匀	虫
蚑	支	虫
蚒	丹	虫
蚓	引	虫
蚔	氏	虫
蚕	天	虫
蚖	元	虫
蚗	夬	虫
蚘	尤	虫
蚙	今	虫
蚚	斤	虫
蚛	中	虫
蚜	牙	虫
蚝	毛	虫
蚞	木	虫
蚟	王	虫
蚠	分	虫
蚡	分	虫
蚢	亢	虫
蚣	公	虫
蚤	叉	虫
蚥	父	虫
蚦	冄	虫
蚧	介	虫
蚨	夫	虫
蚩	㞢	虫
蚪	斗	虫
蚫	包	虫
蚬	虫	见
蚭	尼	虫
蚮	代	虫
蚯	丘	虫
蚰	由	虫
蚱	乍	虫
蚲	平	虫
蚳	氐	虫
蚴	幼	虫
蚵	可	虫
蚶	甘	虫
蚷	巨	虫
蚸	斥	虫
蚹	付	虫
蚺	冉	虫
蚻	札	虫
蚼	句	虫
蚽	丕	虫
蚾	皮	虫
蚿	玄	虫
蛀	主	虫
蛁	召	虫
蛂	犮	虫
蛃	丙	虫
蛄	古	虫
蛅	占	虫
蛆	且	虫
蛇	它	虫
蛈	失	虫
蛉	令	虫
蛊	皿	虫
蛋	疋	虫
蛌	瓜	虫
蛍	冖	虫	𭕄
蛎	厉	虫
蛏	圣	虫
蛐	曲	虫
蛑	牟	虫
蛒	各	虫
蛓	虫	𢦏
蛔	回	虫
蛕	有	虫
蛖	尨	虫
蛗	虫	𠂤
蛘	羊	虫
蛙	圭	虫
蛚	列	虫
蛛	朱	虫
蛜	伊	虫
蛝	艮	虫
蛞	舌	虫
蛟	交	虫
蛠	劦	虫
蛡	羽	虫
蛢	并	虫
蛣	吉	虫
蛤	合	虫
蛥	多	虫
蛦	夷	虫
蛧	网	虫
蛨	百	虫
蛩	巩	虫
蛪	㓞	虫
蛫	危	虫
蛬	共	虫
蛭	至	虫
蛮	亦	虫
蛯	老	虫
蛰	执	虫
蛱	夹	虫
蛲	尧	虫
蛳	师	虫
蛴	虫	齐
蛵	巠	虫
蛶	寽	虫
蛷	求	虫
蛸	肖	虫
蛹	甬	虫
蛺	夾	虫
蛻	兌	虫
蛼	虫	車
蛽	虫	貝
蛾	我	虫
蛿	含	虫
蜀	罒	𠣜
蜁	虫	𭻾
蜂	夆	虫
蜃	虫	辰
蜄	虫	辰
蜅	甫	虫
蜆	虫	見
蜇	折	虫
蜈	吴	虫
蜉	孚	虫
蜊	利	虫
蜋	良	虫
蜌	坒	虫
蜍	余	虫
蜎	肙	虫
蜏	秀	虫
蜐	劫	虫
蜑	延	虫
蜒	延	虫
蜓	廷	虫
蜔	甸	虫
蜕	兑	虫
蜖	囬	虫
蜗	呙	虫
蜘	知	虫
蜙	松	虫
蜚	虫	非
蜛	居	虫
蜜	宓	虫
蜝	其	虫
蜞	其	虫
蜟	育	虫
蜠	囷	虫
蜡	昔	虫
蜢	孟	虫
蜣	羌	虫
蜤	析	虫
蜥	析	虫
蜦	侖	虫
蜧	戾	虫
蜨	疌	虫
蜩	周	虫
蜪	匋	虫
蜫	昆	虫
蜬	函	虫
蜭	臽	虫
蜮	或	虫
蜯	奉	虫
蜰	肥	虫
蜱	卑	虫
蜲	委	虫
蜳	享	虫
蜴	易	虫
蜵	虫	𣶒
蜶	卒	虫
蜷	卷	虫
蜸	臤	虫
蜹	芮	虫
蜺	兒	虫
蜻	虫	青
蜼	虫	隹
蜽	兩	虫
蜾	果	虫
蜿	宛	虫
蝀	東	虫
蝁	亞	虫
蝂	版	虫
蝃	叕	虫
蝄	罔	虫
蝅	虫	𭑈
蝆	芈	虫
蝇	虫	黾
蝈	国	虫
蝉	单	虫
蝊	定	虫
蝋	虫	鼡
蝌	科	虫
蝍	即	虫
蝎	曷	虫
蝏	亭	虫
蝐	冒	虫
蝑	胥	虫
蝒	虫	面
蝓	俞	虫
蝔	皆	虫
蝕	虫	飠
蝖	宣	虫
蝗	皇	虫
蝘	匽	虫
蝙	扁	虫
蝚	柔	虫
蝛	威	虫
蝜	虫	負
蝝	彖	虫
蝞	眉	虫
蝟	胃	虫
蝠	畐	虫
蝡	耎	虫
蝢	虫	頁
蝣	斿	虫
蝤	虫	酋
蝥	敄	虫
蝦	叚	虫
蝧	英	虫
蝨	䖵	卂
蝩	虫	重
蝪	昜	虫
蝫	者	虫
蝬	㚇	虫
蝭	是	虫
蝮	复	虫
蝯	爰	虫
蝰	奎	虫
蝱	䖵	亡
蝲	剌	虫
蝳	毒	虫
蝴	胡	虫
蝵	秋	虫
蝶	枼	虫
蝷	㡿	虫
蝸	咼	虫
蝹	昷	虫
蝺	禹	虫
蝻	南	虫
蝼	娄	虫
蝽	春	虫
蝾	荣	虫
蝿	日	电	虫
螀	将	虫
螁	虫	退
螂	虫	郎
螃	旁	虫
螄	師	虫
螅	息	虫
螆	兹	虫
螇	奚	虫
螈	原	虫
螉	翁	虫
螊	兼	虫
螋	叟	虫
螌	般	虫
融	虫	鬲
螎	虫	鬲
螏	疾	虫
螐	烏	虫
螑	臭	虫
螒	人	虫	𠦝
螓	秦	虫
螔	虒	虫
螕	虫	𣬉
螖	虫	骨
螗	唐	虫
螘	虫	豈
螙	䖵	木
螚	能	虫
螛	害	虫
螜	虫	𣪊
螝	虫	鬼
螞	虫	馬
螟	冥	虫
螠	益	虫
螡	䖵	文
螢	虫	𤇾
螣	䖭	月
螤	㬰	蚉
螥	倉	虫
螦	素	虫
螧	耆	虫
螨	虫	𬜯
螩	條	虫
螪	商	虫
螫	虫	赦
螬	曹	虫
螭	离	虫
螮	帶	虫
螯	敖	虫
螰	虫	鹿
螱	尉	虫
螲	窒	虫
螳	堂	虫
螴	虫	陳
螵	票	虫
螶	䖵	巨
螷	庳	虫
螸	欲	虫
螹	斬	虫
螺	累	虫
螻	婁	虫
螼	堇	虫
螽	䖵	冬
螾	寅	虫
螿	將	虫
蟀	率	虫
蟁	䖵	民
蟂	梟	虫
蟃	曼	虫
蟄	執	虫
蟅	庶	虫
蟆	莫	虫
蟇	莫	虫
蟈	國	虫
蟉	翏	虫
蟊	䖵	矛
蟋	悉	虫
蟌	悤	虫
蟍	梨	虫
蟎	㒼	虫
蟏	萧	虫
蟐	常	虫
蟑	章	虫
蟒	莽	虫
蟓	虫	象
蟔	虫	黑
蟕	虫	觜
蟖	斯	虫
蟗	一	中	冖	出	虫
蟘	虫	貸
蟙	戠	虫
蟚	彭	虫
蟛	彭	虫
蟜	喬	虫
蟝	渠	虫
蟞	敝	虫
蟟	尞	虫
蟠	番	虫
蟡	爲	虫
蟢	喜	虫
蟣	幾	虫
蟤	巽	虫
蟥	虫	黄
蟦	虫	賁
蟧	勞	虫
蟨	厥	虫
蟩	厥	虫
蟪	惠	虫
蟫	虫	覃
蟬	單	虫
蟭	焦	虫
蟮	善	虫
蟯	堯	虫
蟰	肅	虫
蟱	無	虫
蟲	䖵	虫
蟳	尋	虫
蟴	斯	虫
蟵	厨	虫
蟶	聖	虫
蟷	當	虫
蟸	䖵	豕
蟹	虫	解
蟺	亶	虫
蟻	義	虫
蟼	敬	虫
蟽	虫	達
蟾	虫	詹
蟿	虫	𣪠
蠀	虫	資
蠁	虫	鄉
蠂	葉	虫
蠃	凡	吂	月	虫
蠄	禽	虫
蠅	虫	黽
蠆	萬	虫
蠇	萬	虫
蠈	虫	賊
蠉	睘	虫
蠊	廉	虫
蠋	虫	蜀
蠌	睪	虫
蠍	歇	虫
蠎	莾	虫
蠏	虫	解
蠐	虫	齊
蠑	榮	虫
蠒	爾	虫
蠓	蒙	虫
蠔	虫	豪
蠕	虫	需
蠖	蒦	虫
蠗	翟	虫
蠘	截	虫
蠙	虫	賓
蠚	䖵	若
蠛	蔑	虫
蠜	樊	虫
蠝	畾	虫
蠞	節	虫
蠟	巤	虫
蠠	䖵	面
蠡	䖵	彖
蠢	䖵	春
蠣	厲	虫
蠤	䖵	酋
蠥	虫	辥
蠦	盧	虫
蠧	䖵	𥑟
蠨	蕭	虫
蠩	虫	諸
蠪	虫	龍
蠫	䖵	𭃤
蠬	虫	龍
蠭	䖵	逢
蠮	翳	虫
蠯	䖵	庳
蠰	虫	襄
蠱	皿	蟲
蠲	益	蜀
蠳	嬰	虫
蠴	薯	虫
蠵	巂	虫
蠶	䖵	朁
蠷	瞿	虫
蠸	虫	雚
蠹	䖵	一	中	冖	石
蠺	䖵	日	𭑈
蠻	䜌	虫
蠼	矍	虫
蠽	䖵	𢧵
蠾	屬	虫
蠿	䖵	𢇍
血	丿	皿
衁	亡	血
衂	刃	血
衃	不	血
衄	丑	血
衅	半	血
衆	乑	血
衇	血	𠂢
衈	耳	血
衉	各	血
衊	蔑	血
衋	皕	聿	血
行	亍	彳
衍	亍	彳	氵
衎	亍	干	彳
衏	亍	元	彳
衐	亍	巨	彳
衑	亍	令	彳
衒	亍	彳	玄
術	亍	彳	术
衔	亍	彳	钅
衕	亍	同	彳
衖	亍	共	彳
街	亍	圭	彳
衘	亍	彳	𦈢
衙	亍	吾	彳
衚	亍	彳	胡
衛	亍	彳	韋
衜	亍	彳	首
衝	亍	彳	重
衞	亍	彳	𮧮
衟	亍	彳	𩠐
衠	亍	彳	真
衡	亍	彳	𩵋
衢	亍	彳	瞿
衣	亠	𧘇
衤	衤
补	卜	衤
衦	干	衤
衧	于	衤
表	龶	𧘇
衩	叉	衤
衪	也	衤
衫	彡	衤
衬	寸	衤
衭	夫	衤
衮	亠	公	𧘇
衯	分	衤
衰	一	亠	口	𧘇
衱	及	衤
衲	内	衤
衳	公	衤
衴	冘	衤
衵	日	衤
衶	中	衤
衷	中	亠	𧘇
衸	介	衤
衹	氏	衤
衺	亠	牙	𧘇
衻	冄	衤
衼	支	衤
衽	壬	衤
衾	今	衣
衿	今	衤
袀	匀	衤
袁	𠮷	𧘇
袂	夬	衤
袃	切	衣
袄	夭	衤
袅	④	衣
袆	衤	韦
袇	丹	衤
袈	加	衣
袉	它	衤
袊	令	衤
袋	代	衣
袌	亠	包	𧘇
袍	包	衤
袎	幼	衤
袏	左	衤
袐	必	衤
袑	召	衤
袒	旦	衤
袓	且	衤
袔	可	衤
袕	穴	衤
袖	由	衤
袗	㐱	衤
袘	㐌	衤
袙	白	衤
袚	犮	衤
袛	氐	衤
袜	末	衤
袝	付	衤
袞	㕣	亠	𧘇
袟	失	衤
袠	亠	失	𧘇
袡	冉	衤
袢	半	衤
袣	世	衤
袤	亠	矛	𧘇
袥	石	衤
袦	出	衤
袧	句	衤
袨	玄	衤
袩	占	衤
袪	去	衤
被	皮	衤
袬	亠	台	𧘇
袭	衣	龙
袮	尓	衤
袯	发	衤
袰	母	衣
袱	伏	衤
袲	亠	多	𧘇
袳	多	衤
袴	夸	衤
袵	任	衤
袶	夅	衤
袷	合	衤
袸	存	衤
袹	百	衤
袺	吉	衤
袻	而	衤
袼	各	衤
袽	如	衤
袾	朱	衤
袿	圭	衤
裀	因	衤
裁	衣	𢦏
裂	列	衣
裃	衤	𠧗
裄	行	衤
装	壮	衣
裆	当	衤
裇	血	衤
裈	军	衤
裉	艮	衤
裊	⑦	衣
裋	衤	豆
裌	夾	衤
裍	困	衤
裎	呈	衤
裏	亠	里	𧘇
裐	肙	衤
裑	衤	身
裒	亠	臼	𧘇
裓	戒	衤
裔	冏	衣
裕	衤	谷
裖	衤	辰
裗	㐬	衤
裘	求	衣
裙	君	衤
裚	折	衣
裛	亠	邑	𧘇
補	甫	衤
裝	壯	衣
裞	兑	衤
裟	沙	衣
裠	君	衣
裡	衤	里
裢	衤	连
裣	佥	衤
裤	库	衤
裥	衤	间
裦	③	亠	矛	𧘇
裧	炎	衤
裨	卑	衤
裩	昆	衤
裪	匋	衤
裫	衤	𣶒
裬	夌	衤
裭	虎	衤
裮	昌	衤
裯	周	衤
裰	叕	衤
裱	衤	表
裲	兩	衤
裳	衣	𫩠
裴	衣	非
裵	亠	非	𧘇
裶	衤	非
裷	卷	衤
裸	果	衤
裹	亠	果	𧘇
裺	奄	衤
裻	叔	衣
裼	易	衤
製	制	衣
裾	居	衤
裿	奇	衤
褀	其	衤
褁	果	𧘇
褂	卦	衤
褃	肯	衤
褄	妻	衤
褅	帝	衤
褆	是	衤
複	复	衤
褈	衤	重
褉	契	衤
褊	扁	衤
褋	枼	衤
褌	衤	軍
褍	耑	衤
褎	③	亠	禾	𧘇
褏	③	亠	由	𧘇
褐	曷	衤
褑	爰	衤
褒	亠	保	𧘇
褓	保	衤
褔	畐	衤
褕	俞	衤
褖	彖	衤
褗	匽	衤
褘	衤	韋
褙	背	衤
褚	者	衤
褛	娄	衤
褜	胞	衣
褝	单	衤
褞	昷	衤
褟	衤	𦐇
褠	冓	衤
褡	荅	衤
褢	亠	鬼	𧘇
褣	容	衤
褤	衤	袁
褥	衤	辱
褦	能	衤
褧	耿	衣
褨	差	衤
褩	般	衣
褪	衤	退
褫	虒	衤
褬	桑	衤
褭	亠	馬	𧘇
褮	衣	𤇾
褯	席	衤
褰	衣	𡨄
褱	亠	眔	𧘇
褲	庫	衤
褳	衤	連
褴	监	衤
褵	离	衤
褶	習	衤
褷	徙	衤
褸	婁	衤
褹	埶	衤
褺	執	衣
褻	亠	埶	𧘇
褼	䙲	巳	衤
褽	尉	衣
褾	票	衤
褿	曹	衤
襀	衤	責
襁	强	衤
襂	參	衤
襃	③	亠	呆	𧘇
襄	亠	吅	𠀎	𧘇
襅	畢	衤
襆	菐	衤
襇	衤	間
襈	巽	衤
襉	衤	閒
襊	最	衤
襋	棘	衤
襌	單	衤
襍	衤	集
襎	番	衤
襏	發	衤
襐	衤	象
襑	尋	衤
襒	敝	衤
襓	堯	衤
襔	㒼	衤
襕	衤	阑
襖	奥	衤
襗	睪	衤
襘	會	衤
襙	喿	衤
襚	衤	遂
襛	衤	農
襜	衤	詹
襝	僉	衤
襞	衣	辟
襟	禁	衤
襠	當	衤
襡	蜀	衤
襢	亶	衤
襣	衤	鼻
襤	監	衤
襥	僕	衤
襦	衤	需
襧	爾	衤
襨	對	衤
襩	衤	賣
襪	蔑	衤
襫	奭	衤
襬	罷	衤
襭	衤	頡
襮	暴	衤
襯	衤	親
襰	衤	賴
襱	衤	龍
襲	衣	龍
襳	衤	韱
襴	衤	闌
襵	聶	衤
襶	戴	衤
襷	擧	衤
襸	衤	贊
襹	衤	麗
襺	繭	衤
襻	攀	衤
襼	藝	衤
襽	蘭	衤
襾	襾
西	一	𠁤
覀	一	丨	口
要	女	覀
覂	乏	覀
覃	早	覀
覄	伏	覀
覅	勿	要
覆	復	覀
覇	䩗	覀
覈	敫	覀
覉	䩭	覀
覊	䩻	覀
見	儿	目
覌	又	見
覍	小	見
覎	子	見
規	夫	見
覐	爻	見
覑	片	見
覒	毛	見
覓	爫	見
覔	不	見
覕	必	見
視	礻	見
覗	司	見
覘	占	見
覙	尓	見
覚	冖	見	𭕄
覛	見	𠂢
覜	兆	見
覝	㶣	見
覞	見
覟	志	見
覠	君	見
覡	巫	見
覢	炎	見
覣	委	見
覤	虎	見
覥	典	見
覦	俞	見
覧	丶	臣	見	𠂉
覨	咢	見
覩	者	見
親	亲	見
覫	旁	見
覬	見	豈
覭	冥	見
覮	見	𤇾
覯	冓	見
覰	虘	見
覱	斬	見
覲	堇	見
観	見	𮥶
覴	登	見
覵	見	閒
覶	見	𤔔
覷	虚	見
覸	見	間
覹	微	見
覺	見	𦥯
覻	䖒	見
覼	爾	見
覽	一	罒	臣	見	𠂉
覾	審	見
覿	見	賣
觀	見	雚
见	见
观	又	见
觃	子	见
规	夫	见
觅	爫	见
视	礻	见
觇	占	见
览	〢	丶	见	𠂉
觉	冖	见	𭕄
觊	岂	见
觋	巫	见
觌	卖	见
觍	典	见
觎	俞	见
觏	冓	见
觐	堇	见
觑	虚	见
角	角
觓	丩	角
觔	力	角
觕	牛	角
觖	夬	角
觗	氏	角
觘	少	角
觙	及	角
觚	瓜	角
觛	旦	角
觜	此	角
觝	氐	角
觞	角	𠂉	𠃓
觟	圭	角
觠	角	龹
觡	各	角
觢	㓞	角
解	角	𭷔
觤	危	角
觥	光	角
触	虫	角
觧	羊	角
觨	汞	角
觩	求	角
觪	角	辛
觫	束	角
觬	兒	角
觭	奇	角
觮	录	角
觯	单	角
觰	者	角
觱	咸	角
觲	牛	角	𦍌
觳	一	冖	士	殳	角
觴	角	𬀷
觵	角	黄
觶	單	角
觷	角	𦥯
觸	蜀	角
觹	角	雋
觺	疑	角
觻	樂	角
觼	夐	角
觽	嶲	角
觾	燕	角
觿	巂	角
言	言
訁	訁
訂	丁	言
訃	卜	言
訄	九	言
訅	九	言
訆	丩	言
訇	勹	言
計	十	言
訉	凡	言
訊	卂	言
訋	勺	言
訌	工	言
訍	叉	言
討	寸	言
訏	于	言
訐	干	言
訑	也	言
訒	刃	言
訓	川	言
訔	山	言
訕	山	言
訖	乞	言
託	乇	言
記	己	言
訙	丸	言
訚	言	门
訛	化	言
訜	分	言
訝	牙	言
訞	夭	言
訟	公	言
訠	引	言
訡	今	言
訢	斤	言
訣	夬	言
訤	爻	言
訥	内	言
訦	冘	言
訧	尤	言
訨	止	言
訩	凶	言
訪	方	言
訫	心	言
訬	少	言
設	殳	言
訮	开	言
訯	及	言
訰	屯	言
許	午	言
訲	中	言
訳	尺	言
訴	斥	言
訵	四	言
訶	可	言
訷	申	言
訸	禾	言
訹	术	言
診	㐱	言
註	主	言
証	正	言
訽	句	言
訾	此	言
訿	此	言
詀	占	言
詁	古	言
詂	付	言
詃	玄	言
詄	失	言
詅	令	言
詆	氐	言
詇	央	言
詈	罒	言
詉	奴	言
詊	半	言
詋	兄	言
詌	甘	言
詍	世	言
詎	巨	言
詏	幼	言
詐	乍	言
詑	它	言
詒	台	言
詓	去	言
詔	召	言
評	平	言
詖	皮	言
詗	冋	言
詘	出	言
詙	犮	言
詚	旦	言
詛	且	言
詜	言	𠬢
詝	宁	言
詞	司	言
詟	言	龙
詠	永	言
詡	羽	言
詢	旬	言
詣	旨	言
詤	㠩	言
詥	合	言
試	式	言
詧	②	冫	言	𠂊
詨	交	言
詩	寺	言
詪	艮	言
詫	宅	言
詬	后	言
詭	危	言
詮	全	言
詯	自	言
詰	吉	言
話	舌	言
該	亥	言
詳	羊	言
詴	有	言
詵	先	言
詶	州	言
詷	同	言
詸	米	言
詹	儿	厃	言
詺	名	言
詻	各	言
詼	灰	言
詽	幵	言
詾	匈	言
詿	圭	言
誀	耳	言
誁	并	言
誂	兆	言
誃	多	言
誄	耒	言
誅	朱	言
誆	匡	言
誇	夸	言
誈	至	言
誉	兴	言
誊	言	龹
誋	忌	言
誌	志	言
認	忍	言
誎	束	言
誏	良	言
誐	我	言
誑	狂	言
誒	矣	言
誓	折	言
誔	廷	言
誕	延	言
誖	孛	言
誗	利	言
誘	秀	言
誙	巠	言
誚	肖	言
誛	言	𠬶
誜	夋	言
誝	含	言
語	吾	言
誟	孝	言
誠	成	言
誡	戒	言
誢	見	言
誣	巫	言
誤	吴	言
誥	告	言
誦	甬	言
誧	甫	言
誨	每	言
誩	言
說	兌	言
誫	言	辰
説	兑	言
読	売	言
誮	花	言
誯	昌	言
誰	言	隹
誱	疌	言
課	果	言
誳	屈	言
誴	宗	言
誵	肴	言
誶	卒	言
誷	罔	言
誸	弦	言
誹	言	非
誺	來	言
誻	沓	言
誼	宜	言
誽	兒	言
誾	言	門
調	周	言
諀	卑	言
諁	叕	言
諂	臽	言
諃	林	言
諄	享	言
諅	其	言
諆	其	言
談	炎	言
諈	垂	言
諉	委	言
諊	匊	言
請	言	青
諌	東	言
諍	争	言
諎	昔	言
諏	取	言
諐	侃	言
諑	言	豖
諒	京	言
諓	戔	言
諔	叔	言
諕	虎	言
論	侖	言
諗	念	言
諘	表	言
諙	昏	言
諚	定	言
諛	臾	言
諜	枼	言
諝	胥	言
諞	扁	言
諟	是	言
諠	宣	言
諡	㿽	言
諢	言	軍
諣	咼	言
諤	咢	言
諥	言	重
諦	帝	言
諧	皆	言
諨	畐	言
諩	並	言
諪	亭	言
諫	柬	言
諬	言	𮂱
諭	俞	言
諮	咨	言
諯	耑	言
諰	思	言
諱	言	韋
諲	垔	言
諳	言	音
諴	咸	言
諵	南	言
諶	甚	言
諷	言	風
諸	者	言
諹	昜	言
諺	彦	言
諻	皇	言
諼	爰	言
諽	言	革
諾	若	言
諿	咠	言
謀	某	言
謁	曷	言
謂	胃	言
謃	星	言
謄	月	誊
謅	芻	言
謆	扇	言
謇	言	𡨄
謈	共	日	言
謉	言	鬼
謊	荒	言
謋	桀	言
謌	哥	言
謍	言	𤇾
謎	言	迷
謏	叟	言
謐	言	𥁑
謑	奚	言
謒	倉	言
謓	真	言
謔	虐	言
謕	虒	言
謖	畟	言
謗	旁	言
謘	屖	言
謙	兼	言
謚	益	言
講	冓	言
謜	原	言
謝	射	言
謞	言	高
謟	舀	言
謠	䍃	言
謡	䍃	言
謢	言	隻
謣	言	雩
謤	票	言
謥	悤	言
謦	殸	言
謧	离	言
謨	莫	言
謩	莫	言
謪	商	言
謫	啇	言
謬	翏	言
謭	剪	言
謮	言	責
謯	虘	言
謰	言	連
謱	婁	言
謲	參	言
謳	區	言
謴	言	貫
謵	習	言
謶	庶	言
謷	敖	言
謸	敖	言
謹	堇	言
謺	執	言
謻	移	言
謼	虖	言
謽	强	言
謾	曼	言
謿	朝	言
譀	敢	言
譁	華	言
譂	單	言
譃	虚	言
譄	曾	言
譅	歰	言
譆	喜	言
譇	奢	言
譈	敦	言
證	登	言
譊	堯	言
譋	言	閒
譌	爲	言
譍	䧹	言
譎	矞	言
譏	幾	言
譐	尊	言
譑	喬	言
譒	番	言
譓	惠	言
譔	巽	言
譕	無	言
譖	朁	言
譗	答	言
識	戠	言
譙	焦	言
譚	覃	言
譛	替	言
譜	普	言
譝	言	黽
譞	睘	言
譟	喿	言
譠	亶	言
譡	當	言
譢	言	遂
譣	僉	言
譤	敫	言
譥	敫	言
警	敬	言
譧	廉	言
譨	言	農
譩	意	言
譪	葛	言
譫	言	詹
譬	言	辟
譭	毁	言
譮	會	言
譯	睪	言
議	義	言
譱	羊	誩
譲	㐮	言
譳	言	需
譴	言	遣
譵	對	言
譶	言	誩
護	蒦	言
譸	壽	言
譹	言	豪
譺	疑	言
譻	言	賏
譼	一	罒	臣	言	𠂉
譽	與	言
譾	翦	言
譿	慧	言
讀	言	賣
讁	言	適
讂	夐	言
讃	言	賛
讄	畾	言
讅	審	言
讆	衛	言
讇	言	閻
讈	歷	言
讉	言	遺
變	䜌	攵
讋	言	龍
讌	燕	言
讍	噩	言
讎	言	隹
讏	衞	言
讐	言	雔
讑	言	龠
讒	毚	言
讓	襄	言
讔	言	隱
讕	言	闌
讖	言	韱
讗	巂	言
讘	聶	言
讙	言	雚
讚	言	贊
讛	藝	言
讜	言	黨
讝	嚴	言
讞	獻	言
讟	言	讀
讠	讠
计	十	讠
订	丁	讠
讣	卜	讠
认	人	讠
讥	几	讠
讦	干	讠
讧	工	讠
讨	寸	讠
让	上	讠
讪	山	讠
讫	乞	讠
讬	乇	讠
训	川	讠
议	义	讠
讯	卂	讠
记	己	讠
讱	刃	讠
讲	井	讠
讳	讠	韦
讴	区	讠
讵	巨	讠
讶	牙	讠
讷	内	讠
许	午	讠
讹	化	讠
论	仑	讠
讻	凶	讠
讼	公	讠
讽	讠	风
设	殳	讠
访	方	讠
诀	夬	讠
证	正	讠
诂	古	讠
诃	可	讠
评	平	讠
诅	且	讠
识	只	讠
诇	冋	讠
诈	乍	讠
诉	斥	讠
诊	㐱	讠
诋	氐	讠
诌	刍	讠
词	司	讠
诎	出	讠
诏	召	讠
诐	皮	讠
译	讠	𠬤
诒	台	讠
诓	匡	讠
诔	耒	讠
试	式	讠
诖	圭	讠
诗	寺	讠
诘	吉	讠
诙	灰	讠
诚	成	讠
诛	朱	讠
诜	先	讠
话	舌	讠
诞	延	讠
诟	后	讠
诠	全	讠
诡	危	讠
询	旬	讠
诣	旨	讠
诤	争	讠
该	亥	讠
详	羊	讠
诧	宅	讠
诨	军	讠
诩	羽	讠
诪	寿	讠
诫	戒	讠
诬	巫	讠
语	吾	讠
诮	肖	讠
误	吴	讠
诰	告	讠
诱	秀	讠
诲	每	讠
诳	狂	讠
说	兑	讠
诵	甬	讠
诶	矣	讠
请	讠	青
诸	者	讠
诹	取	讠
诺	若	讠
读	卖	讠
诼	讠	豖
诽	讠	非
课	果	讠
诿	委	讠
谀	臾	讠
谁	讠	隹
谂	念	讠
调	周	讠
谄	臽	讠
谅	京	讠
谆	享	讠
谇	卒	讠
谈	炎	讠
谉	审	讠
谊	宜	讠
谋	某	讠
谌	甚	讠
谍	枼	讠
谎	荒	讠
谏	柬	讠
谐	皆	讠
谑	虐	讠
谒	曷	讠
谓	胃	讠
谔	咢	讠
谕	俞	讠
谖	爰	讠
谗	讠	𫥎
谘	咨	讠
谙	讠	音
谚	彦	讠
谛	帝	讠
谜	讠	迷
谝	扁	讠
谞	胥	讠
谟	莫	讠
谠	党	讠
谡	畟	讠
谢	射	讠
谣	䍃	讠
谤	旁	讠
谥	益	讠
谦	兼	讠
谧	讠	𥁑
谨	堇	讠
谩	曼	讠
谪	啇	讠
谫	剪	讠
谬	翏	讠
谭	覃	讠
谮	朁	讠
谯	焦	讠
谰	讠	阑
谱	普	讠
谲	矞	讠
谳	献	讠
谴	讠	遣
谵	詹	讠
谶	讠	韱
谷	谷
谸	千	谷
谹	厷	谷
谺	牙	谷
谻	丮	谷
谼	共	谷
谽	含	谷
谾	空	谷
谿	奚	谷
豀	奚	谷
豁	害	谷
豂	翏	谷
豃	敢	谷
豄	谷	賣
豅	谷	龍
豆	豆
豇	工	豆
豈	山	豆
豉	支	豆
豊	曲	豆
豋	②	冫	豆	𠂊
豌	宛	豆
豍	卑	豆
豎	臤	豆
豏	兼	豆
豐	豆	𠁳
豑	弟	豊
豒	弟	豐
豓	盇	豐
豔	盍	豐
豕	一	𧰨
豖	丶	豕
豗	兀	豕
豘	屯	豕
豙	立	𧰨
豚	月	豕
豛	殳	豕
豜	开	豕
豝	巴	豕
豞	句	豕
豟	戹	豕
豠	且	豕
象	𠂊	𧰨	𫩏
豢	豕	龹
豣	幵	豕
豤	艮	豕
豥	亥	豕
豦	虍	豕
豧	甫	豕
豨	希	豕
豩	豕
豪	亠	冖	口	豕
豫	予	象
豬	者	豕
豭	叚	豕
豮	豕	贲
豯	奚	豕
豰	一	冖	士	殳	豕
豱	昷	豕
豲	原	豕
豳	山	豩
豴	啇	豕
豵	從	豕
豶	豕	賁
豷	壹	豕
豸	豸
豹	勺	豸
豺	才	豸
豻	干	豸
豼	比	豸
豽	内	豸
豾	丕	豸
豿	句	豸
貀	出	豸
貁	穴	豸
貂	召	豸
貃	白	豸
貄	聿	豸
貅	休	豸
貆	亘	豸
貇	艮	豸
貈	舟	豸
貉	各	豸
貊	百	豸
貋	旱	豸
貌	皃	豸
貍	豸	里
貎	兒	豸
貏	卑	豸
貐	俞	豸
貑	叚	豸
貒	耑	豸
貓	苗	豸
貔	豸	𣬉
貕	奚	豸
貖	益	豸
貗	婁	豸
貘	莫	豸
貙	區	豸
貚	單	豸
貛	豸	雚
貜	矍	豸
貝	八	目
貞	⺊	貝
貟	厶	貝
負	貝	𠂊
財	才	貝
貢	工	貝
貣	弋	貝
貤	也	貝
貥	亢	貝
貦	元	貝
貧	分	貝
貨	化	貝
販	反	貝
貪	今	貝
貫	毌	貝
責	貝	龶
貭	十	貝	𠂆
貮	一	弋	貝
貯	宁	貝
貰	世	貝
貱	皮	貝
貲	此	貝
貳	二	弋	貝
貴	貝	𠀐
貵	厶	大	貝
貶	乏	貝
買	罒	貝
貸	代	貝
貹	生	貝
貺	兄	貝
費	弗	貝
貼	占	貝
貽	台	貝
貾	氐	貝
貿	③	刀	貝
賀	加	貝
賁	卉	貝
賂	各	貝
賃	任	貝
賄	有	貝
賅	亥	貝
賆	并	貝
資	次	貝
賈	覀	貝
賉	血	貝
賊	戎	貝
賋	交	貝
賌	亥	貝
賍	庄	貝
賎	㦮	貝
賏	貝
賐	夋	貝
賑	貝	辰
賒	佘	貝
賓	一	宀	貝	𣥂
賔	宀	𮙸
賕	求	貝
賖	余	貝
賗	串	貝
賘	庒	貝
賙	周	貝
賚	來	貝
賛	㚘	貝
賜	易	貝
賝	罙	貝
賞	貝	𫩠
賟	典	貝
賠	咅	貝
賡	庚	貝
賢	臤	貝
賣	士	買
賤	戔	貝
賥	卒	貝
賦	武	貝
賧	炎	貝
賨	宗	貝
賩	宗	貝
質	斦	貝
賫	从	冖	十	貝
賬	貝	長
賭	者	貝
賮	貝	𭴘
賯	㝁	貝
賰	春	貝
賱	貝	軍
賲	保	貝
賳	哉	貝
賴	束	負
賵	冒	貝
賶	倉	貝
賷	冖	十	吅	貝
賸	月	貝	龹
賹	益	貝
賺	兼	貝
賻	尃	貝
購	冓	貝
賽	貝	𡨄
賾	責	𦣞
賿	翏	貝
贀	殹	貝
贁	攵	貝
贂	參	貝
贃	患	貝
贄	執	貝
贅	敖	貝
贆	猋	貝
贇	斌	貝
贈	曾	貝
贉	覃	貝
贊	兟	貝
贋	貝	雁
贌	菐	貝
贍	詹	貝
贎	萬	貝
贏	凡	吂	月	貝
贐	盡	貝
贑	章	貢
贒	忠	臣	貝
贓	臧	貝
贔	貝	賏
贕	卵	賣
贖	貝	賣
贗	貝	鴈
贘	貝	賞
贙	虤	貝
贚	貝	龍
贛	夂	章	貢
贜	藏	貝
贝	贝
贞	⺊	贝
负	贝	𠂊
贠	厶	贝
贡	工	贝
财	才	贝
责	贝	龶
贤	〢	又	贝
败	攵	贝
账	贝	长
货	化	贝
质	十	贝	𠂆
贩	反	贝
贪	今	贝
贫	分	贝
贬	乏	贝
购	勾	贝
贮	㝉	贝
贯	毌	贝
贰	二	弋	贝
贱	戋	贝
贲	卉	贝
贳	世	贝
贴	占	贝
贵	贝	𠀐
贶	兄	贝
贷	代	贝
贸	③	刀	贝
费	弗	贝
贺	加	贝
贻	台	贝
贼	戎	贝
贽	执	贝
贾	覀	贝
贿	有	贝
赀	此	贝
赁	任	贝
赂	各	贝
赃	庄	贝
资	次	贝
赅	亥	贝
赆	尽	贝
赇	求	贝
赈	贝	辰
赉	来	贝
赊	佘	贝
赋	武	贝
赌	者	贝
赍	从	冖	十	贝
赎	卖	贝
赏	贝	𫩠
赐	易	贝
赑	贝
赒	周	贝
赓	庚	贝
赔	咅	贝
赕	炎	贝
赖	束	负
赗	冒	贝
赘	敖	贝
赙	尃	贝
赚	兼	贝
赛	贝	𡨄
赜	责	𦣞
赝	贝	雁
赞	兟	贝
赟	斌	贝
赠	曾	贝
赡	詹	贝
赢	凡	吂	月	贝
赣	夂	章	贡
赤	④	土
赥	欠	赤
赦	攵	赤
赧	赤	𠬝
赨	虫	赤
赩	色	赤
赪	贞	赤
赫	赤
赬	貞	赤
赭	者	赤
赮	叚	赤
赯	唐	赤
走	土	龰
赱	③	土
赲	力	走
赳	丩	走
赴	卜	走
赵	㐅	走
赶	干	走
起	巳	走
赸	山	走
赹	匀	走
赺	今	走
赻	少	走
赼	欠	走
赽	夬	走
赾	斤	走
赿	氏	走
趀	走	𠂔
趁	㐱	走
趂	尔	走
趃	失	走
趄	且	走
超	召	走
趆	氐	走
趇	立	走
趈	占	走
趉	出	走
越	戉	走
趋	刍	走
趌	吉	走
趍	多	走
趎	朱	走
趏	舌	走
趐	羽	走
趑	次	走
趒	兆	走
趓	朵	走
趔	列	走
趕	旱	走
趖	坐	走
趗	走	足
趘	尾	走
趙	肖	走
趚	束	走
趛	走	金
趜	匊	走
趝	念	走
趞	昔	走
趟	尚	走
趠	卓	走
趡	走	隹
趢	录	走
趣	取	走
趤	宕	走
趥	走	酋
趦	咨	走
趧	是	走
趨	芻	走
趩	異	走
趪	走	黃
趫	喬	走
趬	堯	走
趭	焦	走
趮	喿	走
趯	翟	走
趰	爾	走
趱	赞	走
趲	贊	走
足	口	龰
趴	八	𧾷
趵	勺	𧾷
趶	于	𧾷
趷	乞	𧾷
趸	万	足
趹	夬	𧾷
趺	夫	𧾷
趻	今	𧾷
趼	开	𧾷
趽	方	𧾷
趾	止	𧾷
趿	及	𧾷
跀	月	𧾷
跁	巴	𧾷
跂	支	𧾷
跃	夭	𧾷
跄	仓	𧾷
跅	斥	𧾷
跆	台	𧾷
跇	世	𧾷
跈	㐱	𧾷
跉	令	𧾷
跊	未	𧾷
跋	犮	𧾷
跌	失	𧾷
跍	古	𧾷
跎	它	𧾷
跏	加	𧾷
跐	此	𧾷
跑	包	𧾷
跒	可	𧾷
跓	主	𧾷
跔	句	𧾷
跕	占	𧾷
跖	石	𧾷
跗	付	𧾷
跘	半	𧾷
跙	且	𧾷
跚	册	𧾷
跛	皮	𧾷
跜	尼	𧾷
距	巨	𧾷
跞	乐	𧾷
跟	艮	𧾷
跠	夷	𧾷
跡	亦	𧾷
跢	多	𧾷
跣	先	𧾷
跤	交	𧾷
跥	朶	𧾷
跦	朱	𧾷
跧	全	𧾷
跨	夸	𧾷
跩	曳	𧾷
跪	危	𧾷
跫	巩	足
跬	圭	𧾷
跭	夅	𧾷
跮	至	𧾷
路	各	𧾷
跰	并	𧾷
跱	寺	𧾷
跲	合	𧾷
跳	兆	𧾷
跴	西	𧾷
践	戋	𧾷
跶	达	𧾷
跷	尧	𧾷
跸	毕	𧾷
跹	迁	𧾷
跺	朵	𧾷
跻	齐	𧾷
跼	局	𧾷
跽	忌	𧾷
跾	攸	足
跿	走	𧾷
踀	足	𧾷
踁	巠	𧾷
踂	𦔮	𧾷
踃	肖	𧾷
踄	步	𧾷
踅	折	足
踆	夋	𧾷
踇	每	𧾷
踈	束	𧾷
踉	良	𧾷
踊	甬	𧾷
踋	却	𧾷
踌	寿	𧾷
踍	孝	𧾷
踎	否	𧾷
踏	沓	𧾷
踐	戔	𧾷
踑	其	𧾷
踒	委	𧾷
踓	隹	𧾷
踔	卓	𧾷
踕	疌	𧾷
踖	昔	𧾷
踗	念	𧾷
踘	匊	𧾷
踙	取	𧾷
踚	侖	𧾷
踛	坴	𧾷
踜	夌	𧾷
踝	果	𧾷
踞	居	𧾷
踟	知	𧾷
踠	宛	𧾷
踡	卷	𧾷
踢	易	𧾷
踣	咅	𧾷
踤	卒	𧾷
踥	妾	𧾷
踦	奇	𧾷
踧	叔	𧾷
踨	从	龰	𧾷
踩	采	𧾷
踪	宗	𧾷
踫	並	𧾷
踬	质	𧾷
踭	争	𧾷
踮	店	𧾷
踯	郑	𧾷
踰	俞	𧾷
踱	度	𧾷
踲	盾	𧾷
踳	春	𧾷
踴	勇	𧾷
踵	重	𧾷
踶	是	𧾷
踷	者	𧾷
踸	甚	𧾷
踹	耑	𧾷
踺	建	𧾷
踻	咼	𧾷
踼	昜	𧾷
踽	禹	𧾷
踾	畐	𧾷
踿	秋	𧾷
蹀	枼	𧾷
蹁	扁	𧾷
蹂	柔	𧾷
蹃	若	𧾷
蹄	帝	𧾷
蹅	查	𧾷
蹆	退	𧾷
蹇	足	𡨄
蹈	舀	𧾷
蹉	差	𧾷
蹊	奚	𧾷
蹋	𦐇	𧾷
蹌	倉	𧾷
蹍	展	𧾷
蹎	真	𧾷
蹏	虒	𧾷
蹐	脊	𧾷
蹑	聂	𧾷
蹒	䓣	𧾷
蹓	留	𧾷
蹔	斬	足
蹕	畢	𧾷
蹖	舂	𧾷
蹗	鹿	𧾷
蹘	翏	𧾷
蹙	戚	足
蹚	堂	𧾷
蹛	帶	𧾷
蹜	宿	𧾷
蹝	徙	𧾷
蹞	頃	𧾷
蹟	責	𧾷
蹠	庶	𧾷
蹡	將	𧾷
蹢	啇	𧾷
蹣	㒼	𧾷
蹤	從	𧾷
蹥	連	𧾷
蹦	崩	𧾷
蹧	曹	𧾷
蹨	然	𧾷
蹩	敝	足
蹪	貴	𧾷
蹫	矞	𧾷
蹬	登	𧾷
蹭	曾	𧾷
蹮	䙴	𧾷
蹯	番	𧾷
蹰	厨	𧾷
蹱	童	𧾷
蹲	尊	𧾷
蹳	發	𧾷
蹴	就	𧾷
蹵	就	足
蹶	厥	𧾷
蹷	厥	足
蹸	粦	𧾷
蹹	翕	𧾷
蹺	堯	𧾷
蹻	喬	𧾷
蹼	菐	𧾷
蹽	尞	𧾷
蹾	敦	𧾷
蹿	窜	𧾷
躀	貫	𧾷
躁	喿	𧾷
躂	達	𧾷
躃	辟	𧾷
躄	足	辟
躅	蜀	𧾷
躆	豦	𧾷
躇	著	𧾷
躈	敫	𧾷
躉	萬	足
躊	壽	𧾷
躋	齊	𧾷
躌	舞	𧾷
躍	翟	𧾷
躎	爾	𧾷
躏	蔺	𧾷
躐	巤	𧾷
躑	鄭	𧾷
躒	樂	𧾷
躓	質	𧾷
躔	廛	𧾷
躕	廚	𧾷
躖	𢇍	𧾷
躗	衛	足
躘	龍	𧾷
躙	閵	𧾷
躚	遷	𧾷
躛	衞	足
躜	赞	𧾷
躝	闌	𧾷
躞	燮	𧾷
躟	襄	𧾷
躠	薛	足
躡	聶	𧾷
躢	闒	𧾷
躣	瞿	𧾷
躤	藉	𧾷
躥	竄	𧾷
躦	贊	𧾷
躧	麗	𧾷
躨	夔	𧾷
躩	矍	𧾷
躪	藺	𧾷
身	身
躬	弓	身
躭	冘	身
躮	分	身
躯	区	身
躰	本	身
躱	朶	身
躲	朵	身
躳	吕	身
躴	良	身
躵	忍	身
躶	果	身
躷	委	身
躸	奇	身
躹	匊	身
躺	尚	身
躻	空	身
躼	身	長
躽	匽	身
躾	美	身
躿	康	身
軀	區	身
軁	婁	身
軂	勞	身
軃	單	身
軄	戠	身
軅	身	雁
軆	豊	身
軇	壽	身
軈	應	身
軉	寶	身
車	車
軋	乚	車
軌	九	車
軍	冖	車
軎	口	車
軏	兀	車
軐	卂	車
軑	大	車
軒	干	車
軓	凡	車
軔	刃	車
軕	山	車
軖	王	車
軗	殳	車
軘	屯	車
軙	攴	車
軚	太	車
軛	厄	車
軜	内	車
軝	氏	車
軞	毛	車
軟	欠	車
軠	壬	車
軡	今	車
転	云	車
軣	丷	八	車
軤	乎	車
軥	句	車
軦	兄	車
軧	氐	車
軨	令	車
軩	台	車
軪	幼	車
軫	㐱	車
軬	厶	大	車
軭	匡	車
軮	央	車
軯	平	車
軰	北	車
軱	瓜	車
軲	古	車
軳	包	車
軴	主	車
軵	付	車
軶	戹	車
軷	犮	車
軸	由	車
軹	只	車
軺	召	車
軻	可	車
軼	失	車
軽	圣	車
軾	式	車
軿	并	車
輀	而	車
輁	共	車
輂	共	車
較	交	車
輄	光	車
輅	各	車
輆	亥	車
輇	全	車
輈	舟	車
載	車	𢦏
輊	至	車
輋	大	山	車
輌	両	車
輍	谷	車
輎	肖	車
輏	車	酉
輐	完	車
輑	君	車
輒	車	𦔮
輓	免	車
輔	甫	車
輕	巠	車
輖	周	車
輗	兒	車
輘	夌	車
輙	取	車
輚	戔	車
輛	兩	車
輜	甾	車
輝	光	軍
輞	罔	車
輟	叕	車
輠	果	車
輡	臽	車
輢	奇	車
輣	朋	車
輤	車	青
輥	昆	車
輦	㚘	車
輧	幷	車
輨	官	車
輩	車	非
輪	侖	車
輫	車	非
輬	京	車
輭	耎	車
輮	柔	車
輯	咠	車
輰	昜	車
輱	咸	車
輲	耑	車
輳	奏	車
輴	盾	車
輵	曷	車
輶	車	酋
輷	訇	車
輸	俞	車
輹	复	車
輺	車	甾
輻	畐	車
輼	昷	車
輽	畚	車
輾	展	車
輿	一	八	車	𦥑
轀	車	𥁕
轁	舀	車
轂	一	冖	士	殳	車
轃	秦	車
轄	害	車
轅	袁	車
轆	車	鹿
轇	翏	車
轈	巢	車
轉	專	車
轊	彗	車
轋	車	連
轌	車	雪
轍	攵	育	車
轎	喬	車
轏	孱	車
轐	菐	車
轑	尞	車
轒	賁	車
轓	番	車
轔	粦	車
轕	葛	車
轖	嗇	車
轗	感	車
轘	睘	車
轙	義	車
轚	車	𣪠
轛	對	車
轜	車	需
轝	與	車
轞	監	車
轟	䡛	車
轠	畾	車
轡	口	𦆕
轢	樂	車
轣	歷	車
轤	盧	車
轥	藺	車
车	车
轧	乚	车
轨	九	车
轩	干	车
轪	大	车
轫	刃	车
转	专	车
轭	厄	车
轮	仑	车
软	欠	车
轰	双	车
轱	古	车
轲	可	车
轳	卢	车
轴	由	车
轵	只	车
轶	失	车
轷	乎	车
轸	㐱	车
轹	乐	车
轺	召	车
轻	车	𢀖
轼	式	车
载	车	𢦏
轾	至	车
轿	乔	车
辀	舟	车
辁	全	车
辂	各	车
较	交	车
辄	车	𦔮
辅	甫	车
辆	两	车
辇	㚘	车
辈	车	非
辉	光	军
辊	昆	车
辋	罔	车
辌	京	车
辍	叕	车
辎	甾	车
辏	奏	车
辐	畐	车
辑	咠	车
辒	昷	车
输	俞	车
辔	口	纟	车
辕	袁	车
辖	害	车
辗	展	车
辘	车	鹿
辙	攵	育	车
辚	粦	车
辛	十	立
辜	古	辛
辝	台	辛
辞	舌	辛
辟	辛	𡰪
辠	自	辛
辡	辛
辢	束	辛
辣	束	辛
辤	受	辛
辥	辛	𡴎
辦	力	辛
辧	刀	辛
辨	②	辛
辩	讠	辛
辪	止	辛	𠂤
辫	纟	辛
辬	文	辛
辭	辛	𤔔
辮	糸	辛
辯	言	辛
辰	丿	乀	二	厂	𠄌
辱	寸	辰
農	曲	辰
辳	林	辰
辴	單	辰
辵	彡	龰
辶	辶
辷	一	辶
辸	乃	辶
边	力	辶
辺	刀	辶
辻	十	辶
込	入	辶
辽	了	辶
达	大	辶
辿	山	辶
迀	干	辶
迁	千	辶
迂	于	辶
迃	亏	辶
迄	乞	辶
迅	卂	辶
迆	也	辶
过	寸	辶
迈	万	辶
迉	尸	辶
迊	帀	辶
迋	王	辶
迌	月	辶
迍	屯	辶
迎	卬	辶
迏	太	辶
运	云	辶
近	斤	辶
迒	亢	辶
迓	牙	辶
返	反	辶
迕	午	辶
迖	犬	辶
迗	天	辶
还	不	辶
这	文	辶
迚	中	辶
进	井	辶
远	元	辶
违	辶	韦
连	车	辶
迟	尺	辶
迠	占	辶
迡	尼	辶
迢	召	辶
迣	世	辶
迤	㐌	辶
迥	冋	辶
迦	加	辶
迧	申	辶
迨	台	辶
迩	尔	辶
迪	由	辶
迫	白	辶
迬	主	辶
迭	失	辶
迮	乍	辶
迯	外	辶
述	术	辶
迱	它	辶
迲	去	辶
迳	辶	𢀖
迴	回	辶
迵	同	辶
迶	有	辶
迷	米	辶
迸	并	辶
迹	亦	辶
迺	西	辶
迻	多	辶
迼	吉	辶
追	辶	𠂤
迾	列	辶
迿	旬	辶
退	艮	辶
送	关	辶
适	舌	辶
逃	兆	辶
逄	夅	辶
逅	后	辶
逆	屰	辶
逇	地	辶
逈	向	辶
选	先	辶
逊	孙	辶
逋	甫	辶
逌	卣	辶
逍	肖	辶
逎	辶	酉
透	秀	辶
逐	豕	辶
逑	求	辶
递	弟	辶
逓	乕	辶
途	余	辶
逕	巠	辶
逖	狄	辶
逗	豆	辶
逘	矣	辶
這	言	辶
通	甬	辶
逛	狂	辶
逜	吾	辶
逝	折	辶
逞	呈	辶
速	束	辶
造	告	辶
逡	夋	辶
逢	夆	辶
連	車	辶
逤	沙	辶
逥	囬	辶
逦	丽	辶
逧	谷	辶
逨	來	辶
逩	奔	辶
逪	昔	辶
逫	叕	辶
逬	幷	辶
逭	官	辶
逮	辶	隶
逯	录	辶
逰	子	扌	辶	𠂉
週	周	辶
進	辶	隹
逳	育	辶
逴	卓	辶
逵	坴	辶
逶	委	辶
逷	易	辶
逸	兔	辶
逹	幸	辶
逺	辶	𡊮
逻	罗	辶
逼	畐	辶
逽	若	辶
逾	俞	辶
逿	昜	辶
遀	左	月	辶
遁	盾	辶
遂	㒸	辶
遃	彦	辶
遄	耑	辶
遅	辶	𡱝
遆	帝	辶
遇	禺	辶
遈	是	辶
遉	貞	辶
遊	斿	辶
運	軍	辶
遌	咢	辶
遍	扁	辶
過	咼	辶
遏	曷	辶
遐	叚	辶
遑	皇	辶
遒	辶	酋
道	辶	首
達	辶	𦍒
違	辶	韋
遖	南	辶
遗	贵	辶
遘	冓	辶
遙	䍃	辶
遚	叟	辶
遛	留	辶
遜	孫	辶
遝	眔	辶
遞	虒	辶
遟	屖	辶
遠	袁	辶
遡	朔	辶
遢	辶	𦐇
遣	辶	𠳋
遤	辶	馬
遥	䍃	辶
遦	貫	辶
遧	章	辶
遨	敖	辶
適	啇	辶
遪	參	辶
遫	敕	辶
遬	欶	辶
遭	曹	辶
遮	庶	辶
遯	豚	辶
遰	帶	辶
遱	婁	辶
遲	犀	辶
遳	莝	辶
遴	粦	辶
遵	尊	辶
遶	堯	辶
遷	䙲	巳	辶
選	巽	辶
遹	矞	辶
遺	貴	辶
遻	㖾	辶
遼	尞	辶
遽	豦	辶
遾	筮	辶
避	辟	辶
邀	敫	辶
邁	萬	辶
邂	解	辶
邃	㒸	穴	辶
還	睘	辶
邅	亶	辶
邆	登	辶
邇	爾	辶
邈	貌	辶
邉	口	穴	自	辶
邊	臱	辶
邋	巤	辶
邌	辶	黎
邍	备	录	辶
邎	䌛	辶
邏	羅	辶
邐	辶	麗
邑	口	巴
邒	丁	阝
邓	又	阝
邔	己	阝
邕	巛	邑
邖	山	阝
邗	干	阝
邘	于	阝
邙	亡	阝
邚	女	阝
邛	工	阝
邜	夕	阝
邝	广	阝
邞	夫	阝
邟	亢	阝
邠	分	阝
邡	方	阝
邢	开	阝
那	二	刀	阝
邤	斤	阝
邥	冘	阝
邦	丰	阝
邧	元	阝
邨	屯	阝
邩	火	阝
邪	牙	阝
邫	丰	邑
邬	乌	阝
邭	句	阝
邮	由	阝
邯	甘	阝
邰	台	阝
邱	丘	阝
邲	必	阝
邳	丕	阝
邴	丙	阝
邵	召	阝
邶	北	阝
邷	瓦	阝
邸	氐	阝
邹	刍	阝
邺	业	阝
邻	令	阝
邼	匡	阝
邽	圭	阝
邾	朱	阝
邿	寺	阝
郀	夸	阝
郁	有	阝
郂	亥	阝
郃	合	阝
郄	阝	𠫤
郅	至	阝
郆	吉	阝
郇	旬	阝
郈	后	阝
郉	幵	阝
郊	交	阝
郋	自	阝
郌	圭	邑
郍	舟	阝
郎	⑤	丶	阝
郏	夹	阝
郐	会	阝
郑	关	阝
郒	⑤	丶	邑
郓	军	阝
郔	延	阝
郕	成	阝
郖	豆	阝
郗	希	阝
郘	吕	阝
郙	甫	阝
郚	吾	阝
郛	孚	阝
郜	告	阝
郝	赤	阝
郞	良	阝
郟	夾	阝
郠	更	阝
郡	君	阝
郢	呈	阝
郣	孛	阝
郤	谷	阝
郥	貝	阝
郦	丽	阝
郧	员	阝
部	咅	阝
郩	肴	阝
郪	妻	阝
郫	卑	阝
郬	阝	青
郭	享	阝
郮	周	阝
郯	炎	阝
郰	取	阝
郱	并	阝
郲	來	阝
郳	兒	阝
郴	林	阝
郵	垂	阝
郶	咅	邑
郷	⑤	乡	阝
郸	单	阝
郹	狊	阝
郺	多	邕
郻	阝	𥄉
郼	阝	韋
都	者	阝
郾	匽	阝
郿	眉	阝
鄀	若	阝
鄁	背	阝
鄂	咢	阝
鄃	俞	阝
鄄	垔	阝
鄅	禹	阝
鄆	軍	阝
鄇	侯	阝
鄈	癸	阝
鄉	乡	郎
鄊	乡	耶
鄋	叟	阝
鄌	唐	阝
鄍	冥	阝
鄎	息	阝
鄏	辱	阝
鄐	畜	阝
鄑	晋	阝
鄒	芻	阝
鄓	臭	阝
鄔	烏	阝
鄕	乡	皀	阝
鄖	員	阝
鄗	阝	高
鄘	庸	阝
鄙	啚	阝
鄚	莫	阝
鄛	巢	阝
鄜	阝	鹿
鄝	翏	阝
鄞	堇	阝
鄟	專	阝
鄠	阝	雩
鄡	梟	阝
鄢	焉	阝
鄣	章	阝
鄤	曼	阝
鄥	阝	鳥
鄦	無	阝
鄧	登	阝
鄨	敝	邑
鄩	尋	阝
鄪	費	阝
鄫	曾	阝
鄬	爲	阝
鄭	奠	阝
鄮	貿	阝
鄯	善	阝
鄰	粦	阝
鄱	番	阝
鄲	單	阝
鄳	阝	黽
鄴	業	阝
鄵	喿	阝
鄶	會	阝
鄷	豊	阝
鄸	夢	阝
鄹	聚	阝
鄺	廣	阝
鄻	輦	阝
鄼	賛	阝
鄽	廛	阝
鄾	憂	阝
鄿	蕇	阝
酀	燕	阝
酁	毚	阝
酂	赞	阝
酃	阝	霝
酄	阝	雚
酅	巂	阝
酆	豐	阝
酇	贊	阝
酈	阝	麗
酉	酉
酊	丁	酉
酋	丷	酉
酌	勺	酉
配	己	酉
酎	寸	酉
酏	也	酉
酐	干	酉
酑	于	酉
酒	氵	酉
酓	今	酉
酔	卆	酉
酕	毛	酉
酖	冘	酉
酗	凶	酉
酘	殳	酉
酙	斗	酉
酚	分	酉
酛	元	酉
酜	夫	酉
酝	云	酉
酞	太	酉
酟	占	酉
酠	可	酉
酡	它	酉
酢	乍	酉
酣	甘	酉
酤	古	酉
酥	禾	酉
酦	发	酉
酧	守	酉
酨	酉	𢦏
酩	名	酉
酪	各	酉
酫	全	酉
酬	州	酉
酭	有	酉
酮	同	酉
酯	旨	酉
酰	先	酉
酱	丬	夕	酉
酲	呈	酉
酳	幺	月	酉
酴	余	酉
酵	孝	酉
酶	每	酉
酷	告	酉
酸	夋	酉
酹	寽	酉
酺	甫	酉
酻	孚	酉
酼	㐬	酉
酽	严	酉
酾	丽	酉
酿	良	酉
醀	酉	隹
醁	录	酉
醂	林	酉
醃	奄	酉
醄	匋	酉
醅	咅	酉
醆	戔	酉
醇	享	酉
醈	炎	酉
醉	卒	酉
醊	叕	酉
醋	昔	酉
醌	昆	酉
醍	是	酉
醎	咸	酉
醏	者	酉
醐	胡	酉
醑	胥	酉
醒	星	酉
醓	冘	皿	酉
醔	秋	酉
醕	亯	酉
醖	昷	酉
醗	発	酉
醘	盍	酉
醙	叟	酉
醚	迷	酉
醛	荃	酉
醜	酉	鬼
醝	差	酉
醞	酉	𥁕
醟	酉	𤇾
醠	盎	酉
醡	窄	酉
醢	酉	𥁓
醣	唐	酉
醤	将	酉
醥	票	酉
醦	參	酉
醧	區	酉
醨	离	酉
醩	曹	酉
醪	翏	酉
醫	殹	酉
醬	將	酉
醭	菐	酉
醮	焦	酉
醯	㐬	皿	酉
醰	覃	酉
醱	發	酉
醲	農	酉
醳	睪	酉
醴	豊	酉
醵	豦	酉
醶	僉	酉
醷	意	酉
醸	㐮	酉
醹	酉	需
醺	熏	酉
醻	壽	酉
醼	燕	酉
醽	酉	霝
醾	糜	酉
醿	縻	酉
釀	襄	酉
釁	冖	分	同	酉	𦥑
釂	爵	酉
釃	酉	麗
釄	酉	靡
釅	嚴	酉
釆	丿	米
采	木	爫
釈	尺	釆
釉	由	釆
释	釆	𠬤
釋	睪	釆
里	一	甲
重	重
野	予	里
量	旦	里
釐	里	𠩺
金	丷	人	王
釒	釒
釓	乚	金
釔	乙	金
釕	了	金
釖	刀	金
釗	刂	金
釘	丁	金
釙	卜	金
釚	九	金
釛	力	金
釜	丷	父	王
針	十	金
釞	入	金
釟	八	金
釠	几	金
釡	八	金
釢	乃	金
釣	勺	金
釤	彡	金
釥	小	金
釦	口	金
釧	川	金
釨	子	金
釩	凡	金
釪	于	金
釫	亏	金
釬	干	金
釭	工	金
釮	才	金
釯	亡	金
釰	刃	金
釱	大	金
釲	巳	金
釳	乞	金
釴	弋	金
釵	叉	金
釶	也	金
釷	土	金
釸	夕	金
釹	女	金
釺	千	金
釻	丸	金
釼	刄	金
釽	爪	金
釾	牙	金
釿	斤	金
鈀	巴	金
鈁	方	金
鈂	冘	金
鈃	开	金
鈄	斗	金
鈅	月	金
鈆	公	金
鈇	夫	金
鈈	不	金
鈉	内	金
鈊	心	金
鈋	化	金
鈌	夬	金
鈍	屯	金
鈎	勾	金
鈏	引	金
鈐	今	金
鈑	反	金
鈒	及	金
鈓	壬	金
鈔	少	金
鈕	丑	金
鈖	分	金
鈗	允	金
鈘	支	金
鈙	攴	金
鈚	比	金
鈛	戈	金
鈜	厷	金
鈝	牛	金
鈞	匀	金
鈟	弔	金
鈠	殳	金
鈡	中	金
鈢	木	金
鈣	丐	金
鈤	日	金
鈥	火	金
鈦	太	金
鈧	亢	金
鈨	元	金
鈩	户	金
鈪	厄	金
鈫	文	金
鈬	尺	金
鈭	此	金
鈮	尼	金
鈯	出	金
鈰	市	金
鈱	民	金
鈲	瓜	金
鈳	可	金
鈴	令	金
鈵	丙	金
鈶	台	金
鈷	古	金
鈸	犮	金
鈹	皮	金
鈺	玉	金
鈻	㠯	金
鈼	乍	金
鈽	布	金
鈾	由	金
鈿	田	金
鉀	甲	金
鉁	㐱	金
鉂	史	金
鉃	矢	金
鉄	失	金
鉅	巨	金
鉆	占	金
鉇	㐌	金
鉈	它	金
鉉	玄	金
鉊	召	金
鉋	包	金
鉌	禾	金
鉍	必	金
鉎	生	金
鉏	且	金
鉐	石	金
鉑	白	金
鉒	主	金
鉓	巾	金	𠂉
鉔	匝	金
鉕	叵	金
鉖	冬	金
鉗	甘	金
鉘	弗	金
鉙	只	金
鉚	卯	金
鉛	口	金	𠘧
鉜	付	金
鉝	立	金
鉞	戉	金
鉟	丕	金
鉠	央	金
鉡	半	金
鉢	本	金
鉣	去	金
鉤	句	金
鉥	术	金
鉦	正	金
鉧	母	金
鉨	尔	金
鉩	尒	金
鉪	世	金
鉫	加	金
鉬	目	金
鉭	旦	金
鉮	申	金
鉯	以	金
鉰	司	金
鉱	広	金
鉲	卡	金
鉳	北	金
鉴	〢	丶	金	𠂉
鉵	虫	金
鉶	刑	金
鉷	共	金
鉸	交	金
鉹	多	金
鉺	耳	金
鉻	各	金
鉼	并	金
鉽	式	金
鉾	牟	金
鉿	合	金
銀	艮	金
銁	旬	金
銂	州	金
銃	充	金
銄	向	金
銅	同	金
銆	百	金
銇	耒	金
銈	圭	金
銉	聿	金
銊	戌	金
銋	任	金
銌	存	金
銍	至	金
銎	巩	金
銏	册	金
銐	列	金
銑	先	金
銒	幵	金
銓	全	金
銔	㔻	金
銕	夷	金
銖	朱	金
銗	后	金
銘	名	金
銙	夸	金
銚	兆	金
銛	舌	金
銜	亍	彳	金
銝	休	金
銞	旬	金
銟	山	巾	金
銠	老	金
銡	吉	金
銢	二	水	金
銣	如	金
銤	米	金
銥	衣	金
銦	因	金
銧	光	金
銨	安	金
銩	丢	金
銪	有	金
銫	色	金
銬	考	金
銭	㦮	金
銮	亦	金
銯	糸	金
銰	艾	金
銱	吊	金
銲	旱	金
銳	兌	金
銴	折	金
銵	身	金
銶	求	金
銷	肖	金
銸	金	𦔮
銹	秀	金
銺	壯	金
銻	弟	金
銼	坐	金
銽	金	𠯑
銾	汞	金
銿	甬	金
鋀	豆	金
鋁	吕	金
鋂	每	金
鋃	良	金
鋄	又	灭	金
鋅	辛	金
鋆	均	金
鋇	貝	金
鋈	沃	金
鋉	束	金
鋊	谷	金
鋋	延	金
鋌	廷	金
鋍	孛	金
鋎	完	金
鋏	夾	金
鋐	宏	金
鋑	夋	金
鋒	夆	金
鋓	利	金
鋔	免	金
鋕	志	金
鋖	妥	金
鋗	肙	金
鋘	吴	金
鋙	吾	金
鋚	攸	金
鋛	串	金
鋜	足	金
鋝	寽	金
鋞	巠	金
鋟	金	𠬶
鋠	辰	金
鋡	含	金
鋢	孚	金
鋣	邪	金
鋤	助	金
鋥	呈	金
鋦	局	金
鋧	見	金
鋨	我	金
鋩	芒	金
鋪	甫	金
鋫	利	金
鋬	扳	金
鋭	兑	金
鋮	成	金
鋯	告	金
鋰	里	金
鋱	忒	金
鋲	兵	金
鋳	寿	金
鋴	克	金
鋵	秃	金
鋶	㐬	金
鋷	取	金
鋸	居	金
鋹	金	長
鋺	宛	金
鋻	臤	金
鋼	岡	金
鋽	卓	金
鋾	匋	金
鋿	尚	金
錀	侖	金
錁	果	金
錂	夌	金
錃	波	金
錄	彔	金
錅	金	𥝢
錆	金	青
錇	咅	金
錈	卷	金
錉	昏	金
錊	卒	金
錋	朋	金
錌	岸	金
錍	卑	金
錎	臽	金
錏	亞	金
錐	金	隹
錑	戾	金
錒	金	阿
錓	羌	金
錔	沓	金
錕	昆	金
錖	叔	金
錗	委	金
錘	垂	金
錙	甾	金
錚	争	金
錛	奔	金
錜	念	金
錝	宗	金
錞	享	金
錟	炎	金
錠	定	金
錡	奇	金
錢	戔	金
錣	叕	金
錤	其	金
錥	育	金
錦	帛	金
錧	官	金
錨	苗	金
錩	昌	金
錪	典	金
錫	易	金
錬	東	金
錭	周	金
錮	固	金
錯	昔	金
錰	杰	金
錱	玨	金
録	录	金
錳	孟	金
錴	坴	金
錵	花	金
錶	表	金
錷	軋	金
錸	來	金
錹	肯	金
錺	芳	金
錻	武	金
錼	奈	金
錽	金	𡕢
錾	斩	金
錿	虎	金
鍀	㝵	金
鍁	欣	金
鍂	金
鍃	忽	金
鍄	京	金
鍅	法	金
鍆	金	門
鍇	皆	金
鍈	英	金
鍉	是	金
鍊	柬	金
鍋	咼	金
鍌	洗	金
鍍	度	金
鍎	盾	金
鍏	金	韋
鍐	㚇	金
鍑	复	金
鍒	柔	金
鍓	咠	金
鍔	咢	金
鍕	軍	金
鍖	甚	金
鍗	帝	金
鍘	則	金
鍙	洪	金
鍚	昜	金
鍛	段	金
鍜	叚	金
鍝	禺	金
鍞	貞	金
鍟	星	金
鍠	皇	金
鍡	畏	金
鍢	畐	金
鍣	苕	金
鍤	臿	金
鍥	契	金
鍦	施	金
鍧	訇	金
鍨	癸	金
鍩	若	金
鍪	敄	金
鍫	秋	金
鍬	秋	金
鍭	侯	金
鍮	俞	金
鍯	怱	金
鍰	爰	金
鍱	枼	金
鍲	昬	金
鍳	丶	臣	金	𠂉
鍴	耑	金
鍵	建	金
鍶	思	金
鍷	奎	金
鍸	胡	金
鍹	宣	金
鍺	者	金
鍻	曷	金
鍼	咸	金
鍽	扁	金
鍾	重	金
鍿	金	甾
鎀	修	金
鎁	耶	金
鎂	美	金
鎃	派	金
鎄	哀	金
鎅	界	金
鎆	前	金
鎇	眉	金
鎈	差	金
鎉	金	𦐇
鎊	旁	金
鎋	害	金
鎌	兼	金
鎍	索	金
鎎	氣	金
鎏	流	金
鎐	䍃	金
鎑	盍	金
鎒	辱	金
鎓	翁	金
鎔	容	金
鎕	唐	金
鎖	金	𧴪
鎗	倉	金
鎘	金	鬲
鎙	朔	金
鎚	追	金
鎛	尃	金
鎜	般	金
鎝	荅	金
鎞	金	𣬉
鎟	桑	金
鎠	罡	金
鎡	兹	金
鎢	烏	金
鎣	金	𤇾
鎤	晃	金
鎥	條	金
鎦	留	金
鎧	豈	金
鎨	金	隼
鎩	殺	金
鎪	叟	金
鎫	丿	八	冈	夂	金
鎬	金	高
鎭	眞	金
鎮	真	金
鎯	郎	金
鎰	益	金
鎱	袁	金
鎲	党	金
鎳	臬	金
鎴	息	金
鎵	家	金
鎶	哥	金
鎷	金	馬
鎸	金	隽
鎹	送	金
鎺	祖	金
鎻	金	𧴲
鎼	金	𧆠
鎽	峯	金
鎾	昷	金
鎿	拿	金
鏀	金	鹵
鏁	巢	金
鏂	區	金
鏃	族	金
鏄	專	金
鏅	脩	金
鏆	貫	金
鏇	旋	金
鏈	連	金
鏉	欶	金
鏊	敖	金
鏋	㒼	金
鏌	莫	金
鏍	累	金
鏎	畢	金
鏏	彗	金
鏐	翏	金
鏑	啇	金
鏒	參	金
鏓	悤	金
鏔	寅	金
鏕	金	鹿
鏖	金	鹿
鏗	堅	金
鏘	將	金
鏙	崔	金
鏚	戚	金
鏛	常	金
鏜	堂	金
鏝	曼	金
鏞	庸	金
鏟	産	金
鏠	逢	金
鏡	竟	金
鏢	票	金
鏣	庶	金
鏤	婁	金
鏥	宿	金
鏦	從	金
鏧	殸	金
鏨	斬	金
鏩	斬	金
鏪	曹	金
鏫	梨	金
鏬	虖	金
鏭	悉	金
鏮	康	金
鏯	爽	金
鏰	崩	金
鏱	章	金
鏲	牽	金
鏳	曾	金
鏴	路	金
鏵	華	金
鏶	金	集
鏷	菐	金
鏸	惠	金
鏹	强	金
鏺	發	金
鏻	粦	金
鏼	策	金
鏽	肅	金
鏾	散	金
鏿	棠	金
鐀	貴	金
鐁	斯	金
鐂	畱	金
鐃	堯	金
鐄	金	黄
鐅	敝	金
鐆	金	隊
鐇	番	金
鐈	喬	金
鐉	巽	金
鐊	金	陽
鐋	湯	金
鐌	象	金
鐍	矞	金
鐎	焦	金
鐏	尊	金
鐐	尞	金
鐑	結	金
鐒	勞	金
鐓	敦	金
鐔	覃	金
鐕	朁	金
鐖	幾	金
鐗	金	閒
鐘	童	金
鐙	登	金
鐚	惡	金
鐛	景	金
鐜	敦	金
鐝	厥	金
鐞	尋	金
鐟	替	金
鐠	普	金
鐡	䒑	口	金	𢦏
鐢	棥	金
鐣	掌	金
鐤	金	鼎
鐥	善	金
鐦	金	開
鐧	金	間
鐨	費	金
鐩	遂	金
鐪	虜	金
鐫	金	雋
鐬	歲	金
鐭	奥	金
鐮	廉	金
鐯	著	金
鐰	喿	金
鐱	僉	金
鐲	蜀	金
鐳	金	雷
鐴	辟	金
鐵	金	𢧜
鐶	睘	金
鐷	葉	金
鐸	睪	金
鐹	過	金
鐺	當	金
鐻	豦	金
鐼	賁	金
鐽	達	金
鐾	辟	金
鐿	意	金
鑀	愛	金
鑁	金	𡕰
鑂	熏	金
鑃	翟	金
鑄	壽	金
鑅	榮	金
鑆	對	金
鑇	金	齊
鑈	爾	金
鑉	蓋	金
鑊	蒦	金
鑋	輕	金
鑌	賓	金
鑍	賏	金
鑎	匱	金
鑏	寧	金
鑐	金	需
鑑	監	金
鑒	一	罒	臣	金	𠂉
鑓	遣	金
鑔	察	金
鑕	質	金
鑖	蔑	金
鑗	金	黎
鑘	畾	金
鑙	旨	金	𮂱
鑚	賛	金
鑛	廣	金
鑜	賞	金
鑝	莑	辶	金
鑞	巤	金
鑟	賣	金
鑠	樂	金
鑡	金	齒
鑢	慮	金
鑣	金	麃
鑤	暴	金
鑥	金	魯
鑦	賢	金
鑧	寬	金
鑨	金	龍
鑩	噩	金
鑪	盧	金
鑫	金	鍂
鑬	覧	金
鑭	金	闌
鑮	薄	金
鑯	金	韱
鑰	金	龠
鑱	毚	金
鑲	襄	金
鑳	蹇	金
鑴	巂	金
鑵	金	雚
鑶	藏	金
鑷	聶	金
鑸	壘	金
鑹	竄	金
鑺	瞿	金
鑻	攀	金
鑼	羅	金
鑽	贊	金
鑾	䜌	金
鑿	金	𣫞
钀	獻	金
钁	矍	金
钂	金	黨
钃	屬	金
钄	蘭	金
钅	钅
钆	乚	钅
钇	乙	钅
针	十	钅
钉	丁	钅
钊	刂	钅
钋	卜	钅
钌	了	钅
钍	土	钅
钎	千	钅
钏	川	钅
钐	彡	钅
钑	及	钅
钒	凡	钅
钓	勺	钅
钔	钅	门
钕	女	钅
钖	钅	𠃓
钗	叉	钅
钘	开	钅
钙	丐	钅
钚	不	钅
钛	太	钅
钜	巨	钅
钝	屯	钅
钞	少	钅
钟	中	钅
钠	内	钅
钡	贝	钅
钢	冈	钅
钣	反	钅
钤	今	钅
钥	月	钅
钦	欠	钅
钧	匀	钅
钨	乌	钅
钩	勾	钅
钪	亢	钅
钫	方	钅
钬	火	钅
钭	斗	钅
钮	丑	钅
钯	巴	钅
钰	玉	钅
钱	戋	钅
钲	正	钅
钳	甘	钅
钴	古	钅
钵	本	钅
钶	可	钅
钷	叵	钅
钸	布	钅
钹	犮	钅
钺	戉	钅
钻	占	钅
钼	目	钅
钽	旦	钅
钾	甲	钅
钿	田	钅
铀	由	钅
铁	失	钅
铂	白	钅
铃	令	钅
铄	乐	钅
铅	口	钅	𠘧
铆	卯	钅
铇	包	钅
铈	市	钅
铉	玄	钅
铊	它	钅
铋	必	钅
铌	尼	钅
铍	皮	钅
铎	钅	𠬤
铏	刑	钅
铐	考	钅
铑	老	钅
铒	耳	钅
铓	芒	钅
铔	亚	钅
铕	有	钅
铖	成	钅
铗	夹	钅
铘	邪	钅
铙	尧	钅
铚	至	钅
铛	当	钅
铜	同	钅
铝	吕	钅
铞	吊	钅
铟	因	钅
铠	岂	钅
铡	则	钅
铢	朱	钅
铣	先	钅
铤	廷	钅
铥	丢	钅
铦	舌	钅
铧	华	钅
铨	全	钅
铩	杀	钅
铪	合	钅
铫	兆	钅
铬	各	钅
铭	名	钅
铮	争	钅
铯	色	钅
铰	交	钅
铱	衣	钅
铲	产	钅
铳	充	钅
铴	汤	钅
铵	安	钅
银	艮	钅
铷	如	钅
铸	寿	钅
铹	劳	钅
铺	甫	钅
铻	吾	钅
铼	来	钅
铽	忒	钅
链	连	钅
铿	坚	钅
销	肖	钅
锁	钅	𭕆
锂	里	钅
锃	呈	钅
锄	助	钅
锅	呙	钅
锆	告	钅
锇	我	钅
锈	秀	钅
锉	坐	钅
锊	寽	钅
锋	夆	钅
锌	辛	钅
锍	㐬	钅
锎	钅	𫔭
锏	钅	间
锐	兑	钅
锑	弟	钅
锒	良	钅
锓	钅	𠬶
锔	局	钅
锕	钅	阿
锖	钅	青
锗	者	钅
锘	若	钅
错	昔	钅
锚	苗	钅
锛	奔	钅
锜	奇	钅
锝	㝵	钅
锞	果	钅
锟	昆	钅
锠	昌	钅
锡	易	钅
锢	固	钅
锣	罗	钅
锤	垂	钅
锥	钅	隹
锦	帛	钅
锧	质	钅
锨	欣	钅
锩	卷	钅
锪	忽	钅
锫	咅	钅
锬	炎	钅
锭	定	钅
键	建	钅
锯	居	钅
锰	孟	钅
锱	甾	钅
锲	契	钅
锳	英	钅
锴	皆	钅
锵	将	钅
锶	思	钅
锷	咢	钅
锸	臿	钅
锹	秋	钅
锺	重	钅
锻	段	钅
锼	叟	钅
锽	皇	钅
锾	爰	钅
锿	哀	钅
镀	度	钅
镁	美	钅
镂	娄	钅
镃	兹	钅
镄	费	钅
镅	眉	钅
镆	莫	钅
镇	真	钅
镈	尃	钅
镉	钅	鬲
镊	聂	钅
镋	党	钅
镌	钅	隽
镍	臬	钅
镎	拿	钅
镏	留	钅
镐	钅	高
镑	旁	钅
镒	益	钅
镓	家	钅
镔	宾	钅
镕	容	钅
镖	票	钅
镗	堂	钅
镘	曼	钅
镙	累	钅
镚	崩	钅
镛	庸	钅
镜	竟	钅
镝	啇	钅
镞	族	钅
镟	旋	钅
镠	翏	钅
镡	覃	钅
镢	厥	钅
镣	尞	钅
镤	菐	钅
镥	钅	鲁
镦	敦	钅
镧	钅	阑
镨	普	钅
镩	窜	钅
镪	强	钅
镫	登	钅
镬	蒦	钅
镭	钅	雷
镮	睘	钅
镯	蜀	钅
镰	廉	钅
镱	意	钅
镲	察	钅
镳	钅	麃
镴	巤	钅
镵	毚	钅
镶	襄	钅
長	④	一	丿	乀	𠄌
镸	④	𠫔
镹	久	镸
镺	夭	镸
镻	失	镸
镼	屈	镸
镽	尞	镸
镾	爾	镸
长	长
門	𠁣	𠃛
閁	丿	門
閂	一	門
閃	人	門
閄	人	門
閅	丁	門
閆	三	門
閇	下	門
閈	干	門
閉	才	門
閊	山	門
開	开	門
閌	亢	門
閍	方	門
閎	厷	門
閏	王	門
閐	毛	門
閑	木	門
閒	月	門
間	日	門
閔	文	門
閕	牙	門
閖	水	門
閗	斗	門
閘	甲	門
閙	市	門
閚	立	門
閛	平	門
閜	可	門
閝	令	門
閞	弁	門
閟	必	門
閠	玉	門
閡	亥	門
関	关	門
閣	各	門
閤	合	門
閥	伐	門
閦	众	門
閧	共	門
閨	圭	門
閩	虫	門
閪	西	門
閫	困	門
閬	良	門
閭	吕	門
閮	廷	門
閯	沙	門
閰	臼	門
閱	兌	門
閲	兑	門
閳	車	門
閴	貝	門
閵	門	隹
閶	昌	門
閷	杀	閃
閸	亞	門
閹	奄	門
閺	旻	門
閻	臽	門
閼	於	門
閽	昏	門
閾	或	門
閿	受	門
闀	巷	門
闁	門
闂	卷	門
闃	狊	門
闄	要	門
闅	門	𥄎
闆	品	門
闇	門	音
闈	門	韋
闉	垔	門
闊	活	門
闋	癸	門
闌	柬	門
闍	者	門
闎	泉	門
闏	門	風
闐	真	門
闑	臬	門
闒	門	𦐇
闓	豈	門
闔	盍	門
闕	欮	門
闖	門	馬
闗	門	𢇁
闘	門	𭔰
闙	啟	門
闚	規	門
闛	堂	門
關	門	𢇇
闝	敗	門
闞	敢	門
闟	翕	門
闠	貴	門
闡	單	門
闢	辟	門
闣	當	門
闤	睘	門
闥	達	門
闦	豊	門
闧	遠	門
门	门
闩	一	门
闪	人	门
闫	三	门
闬	干	门
闭	才	门
问	口	门
闯	门	马
闰	王	门
闱	门	韦
闲	木	门
闳	厷	门
间	日	门
闵	文	门
闶	亢	门
闷	心	门
闸	甲	门
闹	市	门
闺	圭	门
闻	耳	门
闼	达	门
闽	虫	门
闾	吕	门
闿	岂	门
阀	伐	门
阁	各	门
阂	亥	门
阃	困	门
阄	门	龟
阅	兑	门
阆	良	门
阇	者	门
阈	或	门
阉	奄	门
阊	昌	门
阋	兒	门
阌	受	门
阍	昏	门
阎	臽	门
阏	於	门
阐	单	门
阑	柬	门
阒	狊	门
阓	贵	门
阔	活	门
阕	癸	门
阖	盍	门
阗	真	门
阘	门	𦐇
阙	欮	门
阚	敢	门
阛	睘	门
阜	十	𠂤
阝	阝
阞	力	阝
队	人	阝
阠	卂	阝
阡	千	阝
阢	兀	阝
阣	乞	阝
阤	也	阝
阥	水	阝
阦	火	阝
阧	斗	阝
阨	厄	阝
阩	升	阝
阪	反	阝
阫	不	阝
阬	亢	阝
阭	允	阝
阮	元	阝
阯	止	阝
阰	比	阝
阱	井	阝
防	方	阝
阳	日	阝
阴	月	阝
阵	车	阝
阶	介	阝
阷	正	阝
阸	戹	阝
阹	去	阝
阺	氐	阝
阻	且	阝
阼	乍	阝
阽	占	阝
阾	令	阝
阿	可	阝
陀	它	阝
陁	㐌	阝
陂	皮	阝
陃	丙	阝
附	付	阝
际	示	阝
陆	击	阝
陇	阝	龙
陈	东	阝
陉	阝	𢀖
陊	多	阝
陋	阝	𫠥
陌	百	阝
降	夅	阝
陎	朱	阝
陏	有	阝
限	艮	阝
陑	而	阝
陒	危	阝
陓	夸	阝
陔	亥	阝
陕	夹	阝
陖	夋	阝
陗	肖	阝
陘	巠	阝
陙	辰	阝
陚	武	阝
陛	坒	阝
陜	夾	阝
陝	㚒	阝
陞	阝	𡉼
陟	步	阝
陠	甫	阝
陡	走	阝
院	完	阝
陣	車	阝
除	余	阝
陥	旧	阝	𠂊
陦	寿	阝
陧	圼	阝
陨	员	阝
险	佥	阝
陪	咅	阝
陫	阝	非
陬	取	阝
陭	奇	阝
陮	阝	隹
陯	侖	阝
陰	侌	阝
陱	匊	阝
陲	垂	阝
陳	東	阝
陴	卑	阝
陵	夌	阝
陶	匋	阝
陷	臽	阝
陸	坴	阝
陹	升	日	阝
険	㑒	阝
陻	垔	阝
陼	者	阝
陽	昜	阝
陾	耎	阝
陿	匧	阝
隀	重	阝
隁	匽	阝
隂	人	镸	阝
隃	俞	阝
隄	是	阝
隅	禺	阝
隆	㚅	阝
隇	威	阝
隈	畏	阝
隉	阝	𬛸
隊	㒸	阝
隋	左	月	阝
隌	阝	音
隍	皇	阝
階	皆	阝
随	迶	阝
隐	急	阝
隑	豈	阝
隒	兼	阝
隓	阝	𢀡
隔	阝	鬲
隕	員	阝
隖	烏	阝
隗	阝	鬼
隘	益	阝
隙	阝	𡭴
隚	堂	阝
際	祭	阝
障	章	阝
隝	阝	鳥
隞	敖	阝
隟	巢	阝
隠	阝	𢚩
隡	産	阝
隢	堯	阝
隣	粦	阝
隤	貴	阝
隥	登	阝
隦	辟	阝
隧	遂	阝
隨	遀	阝
隩	奥	阝
險	僉	阝
隫	賁	阝
隬	爾	阝
隭	阝	需
隮	阝	齊
隯	壽	阝
隰	㬎	阝
隱	㥯	阝
隲	少	阝	馬
隳	隋	𠇍
隴	阝	龍
隵	戲	阝
隶	隶
隷	士	示	隶
隸	柰	隶
隹	隹
隺	冖	隹
隻	又	隹
隼	十	隹
隽	乃	隹
难	又	隹
隿	弋	隹
雀	小	隹
雁	倠	厂
雂	今	隹
雃	开	隹
雄	厷	隹
雅	牙	隹
集	木	隹
雇	户	隹
雈	隹	艹
雉	矢	隹
雊	句	隹
雋	④	隹
雌	此	隹
雍	乡	亠	隹
雎	且	隹
雏	刍	隹
雐	虍	隹
雑	杂	隹
雒	各	隹
雓	余	隹
雔	隹
雕	周	隹
雖	虽	隹
雗	人	隹	𠦝
雘	丹	蒦
雙	又	雔
雚	艹	𨾴
雛	芻	隹
雜	木	隹	𠅃
雝	邕	隹
雞	奚	隹
雟	屮	𮥼
雠	讠	隹
雡	翏	隹
離	离	隹
難	口	夫	廿	隹
雤	隹	𦥯
雥	隹	雔
雦	隹
雧	木	雥
雨	一	𠕒
雩	亏	雨
雪	彐	雨
雫	下	雨
雬	木	雨
雭	及	雨
雮	毛	雨
雯	文	雨
雰	分	雨
雱	方	雨
雲	云	雨
雳	历	雨
雴	立	雨
雵	央	雨
零	令	雨
雷	田	雨
雸	甘	雨
雹	包	雨
雺	矛	雨
電	乚	日	雨
雼	石	雨
雽	乎	雨
雾	务	雨
雿	兆	雨
需	而	雨
霁	雨	齐
霂	沐	雨
霃	沈	雨
霄	肖	雨
霅	言	雨
霆	廷	雨
震	辰	雨
霈	沛	雨
霉	每	雨
霊	一	亚	雨
霋	妻	雨
霌	周	雨
霍	隹	雨
霎	妾	雨
霏	雨	非
霐	泓	雨
霑	沾	雨
霒	今	雲
霓	兒	雨
霔	注	雨
霕	屯	雲
霖	林	雨
霗	泠	雨
霘	洞	雨
霙	英	雨
霚	敄	雨
霛	雨	𢏝
霜	相	雨
霝	雨	𠱠
霞	叚	雨
霟	洪	雨
霠	今	立	雨
霡	脉	雨
霢	脈	雨
霣	員	雨
霤	留	雨
霥	冡	雨
霦	彬	雨
霧	務	雨
霨	尉	雨
霩	郭	雨
霪	淫	雨
霫	習	雨
霬	異	雨
霭	谒	雨
霮	湛	雨
霯	登	雨
霰	散	雨
霱	矞	雨
露	路	雨
霳	隆	雨
霴	隶	雲
霵	戢	雨
霶	滂	雨
霷	暘	雨
霸	䩗	雨
霹	辟	雨
霺	微	雨
霻	豊	雨
霼	氣	雲
霽	雨	齊
霾	貍	雨
霿	夂	目	矛	雨
靀	蒙	雨
靁	畾	雨
靂	歷	雨
靃	雔	雨
靄	謁	雨
靅	費	雲
靆	逮	雲
靇	雨	龍
靈	巫	霝
靉	愛	雲
靊	豐	雨
靋	瀝	雨
靌	寳	雨
靍	䳡	雨
靎	雨	鵭
靏	雨	鶴
靐	雷
靑	円	龶
青	月	龶
靓	见	青
靔	气	青
靕	正	青
靖	立	青
靗	光	青
靘	色	青
静	争	青
靚	見	青
靛	定	青
靜	爭	青
靝	氣	青
非	非
靟	毛	非
靠	告	非
靡	非	麻
面	丆	囬
靣	丆	回
靤	包	面
靥	厌	面
靦	見	面
靧	貴	面
靨	厭	面
革	革
靪	丁	革
靫	叉	革
靬	干	革
靭	刃	革
靮	勺	革
靯	土	革
靰	兀	革
靱	刄	革
靲	今	革
靳	斤	革
靴	化	革
靵	丑	革
靶	巴	革
靷	引	革
靸	及	革
靹	内	革
靺	末	革
靻	且	革
靼	旦	革
靽	半	革
靾	世	革
靿	幼	革
鞀	召	革
鞁	皮	革
鞂	禾	革
鞃	弘	革
鞄	包	革
鞅	央	革
鞆	丙	革
鞇	因	革
鞈	合	革
鞉	兆	革
鞊	吉	革
鞋	圭	革
鞌	安	革
鞍	安	革
鞎	艮	革
鞏	巩	革
鞐	革	𠧗
鞑	达	革
鞒	乔	革
鞓	呈	革
鞔	免	革
鞕	更	革
鞖	妥	革
鞗	丨	亻	夂	革
鞘	肖	革
鞙	肙	革
鞚	空	革
鞛	咅	革
鞜	沓	革
鞝	尚	革
鞞	卑	革
鞟	享	革
鞠	匊	革
鞡	拉	革
鞢	枼	革
鞣	柔	革
鞤	封	革
鞥	弇	革
鞦	秋	革
鞧	酋	革
鞨	曷	革
鞩	削	革
鞪	敄	革
鞫	訇	革
鞬	建	革
鞭	便	革
鞮	是	革
鞯	荐	革
鞰	昷	革
鞱	舀	革
鞲	冓	革
鞳	荅	革
鞴	革	𤰇
鞵	奚	革
鞶	般	革
鞷	革	鬲
鞸	畢	革
鞹	郭	革
鞺	堂	革
鞻	婁	革
鞼	貴	革
鞽	喬	革
鞾	華	革
鞿	幾	革
韀	廌	革
韁	畺	革
韂	詹	革
韃	達	革
韄	蒦	革
韅	㬎	革
韆	遷	革
韇	賣	革
韈	蔑	革
韉	薦	革
韊	蘭	革
韋	㐄	口	𫝀
韌	刃	韋
韍	犮	韋
韎	末	韋
韏	韋	龹
韐	合	韋
韑	光	韋
韒	肖	韋
韓	韋	𠦝
韔	長	韋
韕	享	韋
韖	柔	韋
韗	軍	韋
韘	枼	韋
韙	是	韋
韚	革	韋
韛	韋	𤰇
韜	舀	韋
韝	冓	韋
韞	昷	韋
韟	皋	韋
韠	畢	韋
韡	華	韋
韢	惠	韋
韣	蜀	韋
韤	蔑	韋
韥	賣	韋
韦	韦
韧	刃	韦
韨	犮	韦
韩	韦	𠦝
韪	是	韦
韫	昷	韦
韬	舀	韦
韭	一	非
韮	艹	韭
韯	韭	𢦏
韰	韭	𣦼
韱	㦰	韭
韲	③	丫	亠	刀	韭
音	日	立
韴	帀	音
韵	匀	音
韶	召	音
韷	出	音
韸	夆	音
韹	皇	音
韺	英	音
韻	員	音
韼	逢	音
韽	酓	音
韾	殸	音
響	鄉	音
頀	蒦	音
頁	頁
頂	丁	頁
頃	匕	頁
頄	九	頁
項	工	頁
順	川	頁
頇	干	頁
須	彡	頁
頉	止	頁
頊	王	頁
頋	厄	頁
頌	公	頁
頍	支	頁
頎	斤	頁
頏	亢	頁
預	予	頁
頑	元	頁
頒	分	頁
頓	屯	頁
頔	由	頁
頕	占	頁
頖	半	頁
頗	皮	頁
領	令	頁
頙	正	頁
頚	圣	頁
頛	耒	頁
頜	合	頁
頝	交	頁
頞	安	頁
頟	各	頁
頠	危	頁
頡	吉	頁
頢	舌	頁
頣	臣	頁
頤	頁	𦣞
頥	丨	臣	頁
頦	亥	頁
頧	頁	𠂤
頨	羽	頁
頩	并	頁
頪	米	頁
頫	兆	頁
頬	夹	頁
頭	豆	頁
頮	廾	水	頁
頯	頁	𢌳
頰	夾	頁
頱	寽	頁
頲	廷	頁
頳	赤	頁
頴	頁	𥘈
頵	君	頁
頶	告	頁
頷	含	頁
頸	巠	頁
頹	禿	頁
頺	秀	頁
頻	步	頁
頼	束	頁
頽	秃	頁
頾	此	須
頿	彡	此	頁
顀	隹	頁
顁	定	頁
顂	來	頁
顃	炎	頁
顄	函	頁
顅	肩	頁
顆	果	頁
顇	卒	頁
顈	匕	糸	頁
顉	金	頁
顊	阜	頁
顋	思	頁
題	是	頁
額	客	頁
顎	咢	頁
顏	彥	頁
顐	軍	頁
顑	咸	頁
顒	禺	頁
顓	耑	頁
顔	彦	頁
顕	显	頁
顖	恖	頁
顗	豈	頁
願	原	頁
顙	桑	頁
顚	眞	頁
顛	真	頁
顜	冓	頁
顝	頁	骨
類	頁	类
顟	翏	頁
顠	票	頁
顡	豙	頁
顢	㒼	頁
顣	戚	頁
顤	堯	頁
顥	景	頁
顦	焦	頁
顧	雇	頁
顨	丌	𩔊
顩	僉	頁
顪	歲	頁
顫	亶	頁
顬	需	頁
顭	夢	頁
顮	賓	頁
顯	㬎	頁
顰	卑	頻
顱	盧	頁
顲	頁	𤎭
顳	聶	頁
顴	雚	頁
页	页
顶	丁	页
顷	匕	页
顸	干	页
项	工	页
顺	川	页
须	彡	页
顼	王	页
顽	元	页
顾	厄	页
顿	屯	页
颀	斤	页
颁	分	页
颂	公	页
颃	亢	页
预	予	页
颅	卢	页
领	令	页
颇	皮	页
颈	页	𢀖
颉	吉	页
颊	夹	页
颋	廷	页
颌	合	页
颍	匕	水	页
颎	页	𭴁
颏	亥	页
颐	页	𦣞
频	步	页
颒	廾	水	頁
颓	秃	页
颔	含	页
颕	页	𥘈
颖	匕	禾	页
颗	果	页
题	是	页
颙	禺	页
颚	咢	页
颛	耑	页
颜	彦	页
额	客	页
颞	聂	页
颟	页	𬜯
颠	真	页
颡	桑	页
颢	景	页
颣	米	糸	页
颤	亶	页
颥	需	页
颦	卑	频
颧	雚	页
風	䖝	几
颩	彡	風
颪	下	風
颫	夫	風
颬	牙	風
颭	占	風
颮	包	風
颯	立	風
颰	犮	風
颱	台	風
颲	列	風
颳	舌	風
颴	風	𭻾
颵	肖	風
颶	具	風
颷	炎	風
颸	思	風
颹	韋	風
颺	昜	風
颻	䍃	風
颼	叟	風
颽	豈	風
颾	蚤	風
颿	風	馬
飀	留	風
飁	習	風
飂	翏	風
飃	票	風
飄	票	風
飅	畱	風
飆	猋	風
飇	猋	風
飈	焱	風
飉	尞	風
飊	焱	風
飋	瑟	風
飌	雚	風
飍	䬕	風
风	㐅	几
飏	风	𠃓
飐	占	风
飑	包	风
飒	立	风
飓	具	风
飔	思	风
飕	叟	风
飖	䍃	风
飗	留	风
飘	票	风
飙	猋	风
飚	焱	风
飛	飛
飜	番	飛
飝	飛
飞	飞
食	人	良
飠	⑤	丶	人
飡	冫	食
飢	几	飠
飣	丁	飠
飤	人	飠
飥	乇	飠
飦	干	飠
飧	夕	食
飨	乡	食
飩	屯	飠
飪	壬	飠
飫	夭	飠
飬	良	龹
飭	力	飠	𠂉
飮	欠	𩙿
飯	反	飠
飰	卞	飠
飱	歹	食
飲	欠	飠
飳	主	飠
飴	台	飠
飵	乍	飠
飶	必	飠
飷	且	飠
飸	号	食
飹	卯	飠
飺	此	食
飻	㐱	飠
飼	司	飠
飽	包	飠
飾	巾	飠	𠂉
飿	出	飠
餀	艾	飠
餁	任	飠
餂	舌	飠
餃	交	飠
餄	合	飠
餅	并	飠
餆	兆	飠
餇	同	飠
餈	次	食
餉	向	飠
養	食	𦍌
餋	食	龹
餌	耳	飠
餍	厌	食
餎	各	飠
餏	衣	飠
餐	食	𣦼
餑	孛	飠
餒	妥	飠
餓	我	飠
餔	甫	飠
餕	夋	飠
餖	豆	飠
餗	束	飠
餘	余	飠
餙	希	飠
餚	肴	飠
餛	昆	飠
餜	果	飠
餝	芳	飠
餞	戔	飠
餟	叕	飠
餠	幷	飠
餡	臽	飠
餢	咅	飠
餣	奄	飠
餤	炎	飠
餥	非	食
餦	長	飠
餧	委	飠
館	官	飠
餩	亥	人	飠
餪	耎	飠
餫	軍	飠
餬	胡	飠
餭	皇	飠
餮	殄	食
餯	彖	飠
餰	衍	飠
餱	侯	飠
餲	曷	飠
餳	昜	飠
餴	奔	飠
餵	畏	飠
餶	飠	骨
餷	查	飠
餸	送	飠
餹	唐	飠
餺	尃	飠
餻	羔	飠
餼	氣	飠
餽	飠	鬼
餾	留	飠
餿	叟	飠
饀	舀	飠
饁	盍	飠
饂	昷	飠
饃	莫	飠
饄	堂	飠
饅	曼	飠
饆	畢	飠
饇	區	飠
饈	羞	飠
饉	堇	飠
饊	散	飠
饋	貴	飠
饌	巽	飠
饍	善	飠
饎	喜	飠
饏	敢	食
饐	壹	飠
饑	幾	飠
饒	堯	飠
饓	棠	飠
饔	雍	食
饕	號	食
饖	歲	飠
饗	鄉	食
饘	亶	飠
饙	賁	飠
饚	蓋	飠
饛	蒙	飠
饜	厭	食
饝	磨	飠
饞	毚	飠
饟	襄	飠
饠	羅	飠
饡	贊	飠
饢	囊	飠
饣	饣
饤	丁	饣
饥	几	饣
饦	乇	饣
饧	饣	𠃓
饨	屯	饣
饩	气	饣
饪	壬	饣
饫	夭	饣
饬	力	饣	𠂉
饭	反	饣
饮	欠	饣
饯	戋	饣
饰	巾	饣	𠂉
饱	包	饣
饲	司	饣
饳	出	饣
饴	台	饣
饵	耳	饣
饶	尧	饣
饷	向	饣
饸	合	饣
饹	各	饣
饺	交	饣
饻	衣	饣
饼	并	饣
饽	孛	饣
饾	豆	饣
饿	我	饣
馀	余	饣
馁	妥	饣
馂	夋	饣
馃	果	饣
馄	昆	饣
馅	臽	饣
馆	官	饣
馇	查	饣
馈	贵	饣
馉	饣	骨
馊	叟	饣
馋	饣	𫥎
馌	盍	饣
馍	莫	饣
馎	尃	饣
馏	留	饣
馐	羞	饣
馑	堇	饣
馒	曼	饣
馓	散	饣
馔	巽	饣
馕	囊	饣
首	䒑	自
馗	九	首
馘	或	首
香	日	禾
馚	分	香
馛	犮	香
馜	尼	香
馝	必	香
馞	孛	香
馟	孚	香
馠	含	香
馡	非	香
馢	戔	香
馣	奄	香
馤	曷	香
馥	复	香
馦	兼	香
馧	香	𥁕
馨	殸	香
馩	賁	香
馪	賓	香
馫	香	𩡐
馬	⑥	灬
馭	又	馬
馮	冫	馬
馯	干	馬
馰	勺	馬
馱	大	馬
馲	乇	馬
馳	也	馬
馴	川	馬
馵	廾	馬
馶	支	馬
馷	巿	馬
馸	斤	馬
馹	日	馬
馺	及	馬
馻	允	馬
馼	文	馬
馽	中	馬
馾	冘	馬
馿	户	馬
駀	尤	馬
駁	爻	馬
駂	馬	𠤏
駃	夬	馬
駄	太	馬
駅	尺	馬
駆	区	馬
駇	攵	馬
駈	丘	馬
駉	冋	馬
駊	皮	馬
駋	召	馬
駌	夗	馬
駍	平	馬
駎	由	馬
駏	巨	馬
駐	主	馬
駑	奴	馬
駒	句	馬
駓	丕	馬
駔	且	馬
駕	加	馬
駖	令	馬
駗	㐱	馬
駘	台	馬
駙	付	馬
駚	央	馬
駛	史	馬
駜	必	馬
駝	它	馬
駞	㐌	馬
駟	四	馬
駠	卯	馬
駡	吅	馬
駢	并	馬
駣	兆	馬
駤	至	馬
駥	戎	馬
駦	馬	龹
駧	同	馬
駨	旬	馬
駩	全	馬
駪	先	馬
駫	光	馬
駬	耳	馬
駭	亥	馬
駮	交	馬
駯	朱	馬
駰	因	馬
駱	各	馬
駲	州	馬
駳	延	馬
駴	戒	馬
駵	丣	馬
駶	局	馬
駷	束	馬
駸	馬	𠬶
駹	尨	馬
駺	良	馬
駻	旱	馬
駼	余	馬
駽	肙	馬
駾	兑	馬
駿	夋	馬
騀	我	馬
騁	甹	馬
騂	辛	馬
騃	矣	馬
騄	录	馬
騅	隹	馬
騆	周	馬
騇	舍	馬
騈	幷	馬
騉	昆	馬
騊	匋	馬
騋	來	馬
騌	宗	馬
騍	果	馬
騎	奇	馬
騏	其	馬
騐	念	馬
騑	非	馬
騒	馬	𧈡
験	㑒	馬
騔	曷	馬
騕	要	馬
騖	敄	馬
騗	扁	馬
騘	怱	馬
騙	扁	馬
騚	前	馬
騛	飛	馬
騜	皇	馬
騝	建	馬
騞	砉	馬
騟	俞	馬
騠	是	馬
騡	泉	馬
騢	叚	馬
騣	㚇	馬
騤	癸	馬
騥	柔	馬
騦	思	馬
騧	咼	馬
騨	単	馬
騩	馬	鬼
騪	叟	馬
騫	馬	𡨄
騬	乘	馬
騭	陟	馬
騮	留	馬
騯	旁	馬
騰	月	駦
騱	奚	馬
騲	草	馬
騳	馬
騴	晏	馬
騵	原	馬
騶	芻	馬
騷	蚤	馬
騸	扇	馬
騹	堇	馬
騺	執	馬
騻	爽	馬
騼	馬	鹿
騽	習	馬
騾	累	馬
騿	章	馬
驀	莫	馬
驁	敖	馬
驂	參	馬
驃	票	馬
驄	悤	馬
驅	區	馬
驆	畢	馬
驇	埶	馬
驈	矞	馬
驉	虚	馬
驊	華	馬
驋	發	馬
驌	肅	馬
驍	堯	馬
驎	粦	馬
驏	孱	馬
驐	敦	馬
驑	畱	馬
驒	單	馬
驓	曾	馬
驔	覃	馬
驕	喬	馬
驖	馬	𢧜
驗	僉	馬
驘	凡	吂	月	馬
驙	亶	馬
驚	敬	馬
驛	睪	馬
驜	業	馬
驝	槖	馬
驞	賓	馬
驟	聚	馬
驠	燕	馬
驡	馬	龍
驢	盧	馬
驣	馬	駦
驤	襄	馬
驥	冀	馬
驦	霜	馬
驧	鞠	馬
驨	巂	馬
驩	雚	馬
驪	馬	麗
驫	馬	騳
马	②	一
驭	又	马
驮	大	马
驯	川	马
驰	也	马
驱	区	马
驲	日	马
驳	爻	马
驴	户	马
驵	且	马
驶	史	马
驷	四	马
驸	付	马
驹	句	马
驺	刍	马
驻	主	马
驼	它	马
驽	奴	马
驾	加	马
驿	马	𠬤
骀	台	马
骁	尧	马
骂	吅	马
骃	因	马
骄	乔	马
骅	华	马
骆	各	马
骇	亥	马
骈	并	马
骉	马
骊	丽	马
骋	甹	马
验	佥	马
骍	辛	马
骎	马	𠬶
骏	夋	马
骐	其	马
骑	奇	马
骒	果	马
骓	隹	马
骔	宗	马
骕	肃	马
骖	参	马
骗	扁	马
骘	陟	马
骙	癸	马
骚	蚤	马
骛	敄	马
骜	敖	马
骝	留	马
骞	马	𡨄
骟	扇	马
骠	票	马
骡	累	马
骢	悤	马
骣	孱	马
骤	聚	马
骥	冀	马
骦	霜	马
骧	襄	马
骨	⑤	月
骩	九	骨
骪	凡	骨
骫	丸	骨
骬	于	骨
骭	干	骨
骮	弋	骨
骯	亢	骨
骰	殳	骨
骱	介	骨
骲	包	骨
骳	皮	骨
骴	此	骨
骵	本	骨
骶	氐	骨
骷	古	骨
骸	亥	骨
骹	交	骨
骺	后	骨
骻	夸	骨
骼	各	骨
骽	妥	骨
骾	更	骨
骿	并	骨
髀	卑	骨
髁	果	骨
髂	客	骨
髃	禺	骨
髄	迶	骨
髅	娄	骨
髆	尃	骨
髇	骨	高
髈	旁	骨
髉	隺	骨
髊	差	骨
髋	宽	骨
髌	宾	骨
髍	骨	麻
髎	翏	骨
髏	婁	骨
髐	堯	骨
髑	蜀	骨
髒	葬	骨
髓	遀	骨
體	豊	骨
髕	賓	骨
髖	寬	骨
髗	盧	骨
高	亠	冋	口
髙	④	亠	冋
髚	亢	高
髛	尻	高
髜	昇	高
髝	勞	高
髞	喿	高
髟	彡	镸
髠	几	髟
髡	兀	髟
髢	也	髟
髣	方	髟
髤	木	髟
髥	冄	髟
髦	毛	髟
髧	冘	髟
髨	元	髟
髩	丏	髟
髪	友	髟
髫	召	髟
髬	丕	髟
髭	此	髟
髮	犮	髟
髯	冉	髟
髰	世	髟
髱	包	髟
髲	皮	髟
髳	矛	髟
髴	弗	髟
髵	而	髟
髶	耳	髟
髷	曲	髟
髸	共	髟
髹	休	髟
髺	舌	髟
髻	吉	髟
髼	夆	髟
髽	坐	髟
髾	肖	髟
髿	沙	髟
鬀	弟	髟
鬁	利	髟
鬂	兵	髟
鬃	宗	髟
鬄	易	髟
鬅	朋	髟
鬆	松	髟
鬇	争	髟
鬈	卷	髟
鬉	㚇	髟
鬊	春	髟
鬋	前	髟
鬌	左	月	髟
鬍	胡	髟
鬎	剌	髟
鬏	秋	髟
鬐	耆	髟
鬑	兼	髟
鬒	真	髟
鬓	宾	髟
鬔	逢	髟
鬕	莫	髟
鬖	參	髟
鬗	㒼	髟
鬘	曼	髟
鬙	曾	髟
鬚	須	髟
鬛	⑦	髟	龱
鬜	閒	髟
鬝	間	髟
鬞	農	髟
鬟	睘	髟
鬠	會	髟
鬡	寧	髟
鬢	賓	髟
鬣	巤	髟
鬤	襄	髟
鬥	𩰊	𩰋
鬦	斗	鬥
鬧	市	鬥
鬨	共	鬥
鬩	兒	鬥
鬪	鬥	𭔰
鬫	敢	鬥
鬬	斲	鬥
鬭	斲	鬥
鬮	鬥	龜
鬯	匕	𠚍
鬰	冖	彡	棥	鬯
鬱	冖	彡	木	缶	鬯
鬲	一	丅	口	𦉪
鬳	虍	鬲
鬴	甫	鬲
鬵	兓	鬲
鬶	规	鬲
鬷	㚇	鬲
鬸	留	鬲
鬹	規	鬲
鬺	鬲	𬀷
鬻	粥	鬲
鬼	儿	厶	甶
鬽	彡	鬼
鬾	支	鬼
鬿	斤	鬼
魀	介	鬼
魁	斗	鬼
魂	云	鬼
魃	犮	鬼
魄	白	鬼
魅	未	鬼
魆	戉	鬼
魇	厌	鬼
魈	肖	鬼
魉	两	鬼
魊	或	鬼
魋	隹	鬼
魌	其	鬼
魍	罔	鬼
魎	兩	鬼
魏	委	鬼
魐	兼	鬼
魑	离	鬼
魒	票	鬼
魓	畢	鬼
魔	鬼	麻
魕	幾	鬼
魖	虚	鬼
魗	壽	鬼
魘	厭	鬼
魙	漸	鬼
魚	灬	田	𠂊
魛	刀	魚
魜	人	魚
魝	刂	魚
魞	入	魚
魟	工	魚
魠	乇	魚
魡	勺	魚
魢	己	魚
魣	予	魚
魤	化	魚
魥	及	魚
魦	少	魚
魧	亢	魚
魨	屯	魚
魩	勿	魚
魪	介	魚
魫	冘	魚
魬	反	魚
魭	元	魚
魮	比	魚
魯	日	魚
魰	文	魚
魱	互	魚
魲	户	魚
魳	帀	魚
魴	方	魚
魵	分	魚
魶	内	魚
魷	尤	魚
魸	片	魚
魹	毛	魚
魺	可	魚
魻	甲	魚
魼	去	魚
魽	甘	魚
魾	丕	魚
魿	令	魚
鮀	它	魚
鮁	犮	魚
鮂	囚	魚
鮃	平	魚
鮄	弗	魚
鮅	必	魚
鮆	此	魚
鮇	未	魚
鮈	句	魚
鮉	召	魚
鮊	白	魚
鮋	由	魚
鮌	玄	魚
鮍	皮	魚
鮎	占	魚
鮏	生	魚
鮐	台	魚
鮑	包	魚
鮒	付	魚
鮓	乍	魚
鮔	巨	魚
鮕	古	魚
鮖	石	魚
鮗	冬	魚
鮘	代	魚
鮙	羽	魚
鮚	吉	魚
鮛	尗	魚
鮜	后	魚
鮝	魚	龹
鮞	而	魚
鮟	安	魚
鮠	危	魚
鮡	兆	魚
鮢	朱	魚
鮣	印	魚
鮤	列	魚
鮥	各	魚
鮦	同	魚
鮧	夷	魚
鮨	旨	魚
鮩	并	魚
鮪	有	魚
鮫	交	魚
鮬	夸	魚
鮭	圭	魚
鮮	羊	魚
鮯	合	魚
鮰	回	魚
鮱	老	魚
鮲	伏	魚
鮳	考	魚
鮴	休	魚
鮵	兑	魚
鮶	君	魚
鮷	弟	魚
鮸	免	魚
鮹	肖	魚
鮺	羊	魚
鮻	夋	魚
鮼	魚	𠬶
鮽	余	魚
鮾	妥	魚
鮿	魚	𦔮
鯀	系	魚
鯁	更	魚
鯂	酉	魚
鯃	吾	魚
鯄	求	魚
鯅	延	魚
鯆	甫	魚
鯇	完	魚
鯈	丨	亻	夂	魚
鯉	里	魚
鯊	沙	魚
鯋	沙	魚
鯌	告	魚
鯍	㐬	魚
鯎	成	魚
鯏	利	魚
鯐	走	魚
鯑	希	魚
鯒	甬	魚
鯓	身	魚
鯔	甾	魚
鯕	其	魚
鯖	青	魚
鯗	䒑	夫	魚
鯘	委	魚
鯙	享	魚
鯚	季	魚
鯛	周	魚
鯜	妾	魚
鯝	固	魚
鯞	帚	魚
鯟	東	魚
鯠	來	魚
鯡	非	魚
鯢	兒	魚
鯣	易	魚
鯤	昆	魚
鯥	坴	魚
鯦	咎	魚
鯧	昌	魚
鯨	京	魚
鯩	侖	魚
鯪	夌	魚
鯫	取	魚
鯬	魚	𥝢
鯭	孟	魚
鯮	宗	魚
鯯	制	魚
鯰	念	魚
鯱	虎	魚
鯲	於	魚
鯳	底	魚
鯴	虱	魚
鯵	参	魚
鯶	軍	魚
鯷	是	魚
鯸	侯	魚
鯹	星	魚
鯺	者	魚
鯻	剌	魚
鯼	㚇	魚
鯽	即	魚
鯾	便	魚
鯿	扁	魚
鰀	爰	魚
鰁	泉	魚
鰂	則	魚
鰃	畏	魚
鰄	威	魚
鰅	禺	魚
鰆	春	魚
鰇	柔	魚
鰈	枼	魚
鰉	皇	魚
鰊	柬	魚
鰋	匽	魚
鰌	酋	魚
鰍	秋	魚
鰎	建	魚
鰏	畐	魚
鰐	咢	魚
鰑	昜	魚
鰒	复	魚
鰓	思	魚
鰔	咸	魚
鰕	叚	魚
鰖	左	月	魚
鰗	胡	魚
鰘	室	魚
鰙	若	魚
鰚	宣	魚
鰛	昷	魚
鰜	兼	魚
鰝	高	魚
鰞	烏	魚
鰟	旁	魚
鰠	蚤	魚
鰡	留	魚
鰢	馬	魚
鰣	時	魚
鰤	師	魚
鰥	眔	魚
鰦	兹	魚
鰧	月	鮝
鰨	魚	𦐇
鰩	䍃	魚
鰪	盍	魚
鰫	容	魚
鰬	虔	魚
鰭	耆	魚
鰮	魚	𥁕
鰯	弱	魚
鰰	神	魚
鰱	連	魚
鰲	敖	魚
鰳	勒	魚
鰴	一	山	彳	攵	魚
鰵	敏	魚
鰶	祭	魚
鰷	條	魚
鰸	區	魚
鰹	堅	魚
鰺	參	魚
鰻	曼	魚
鰼	習	魚
鰽	曹	魚
鰾	票	魚
鰿	責	魚
鱀	既	魚
鱁	逐	魚
鱂	將	魚
鱃	羞	魚
鱄	專	魚
鱅	庸	魚
鱆	章	魚
鱇	康	魚
鱈	雪	魚
鱉	敝	魚
鱊	矞	魚
鱋	虚	魚
鱌	象	魚
鱍	發	魚
鱎	喬	魚
鱏	覃	魚
鱐	肅	魚
鱑	魚	黄
鱒	尊	魚
鱓	單	魚
鱔	善	魚
鱕	番	魚
鱖	厥	魚
鱗	粦	魚
鱘	尋	魚
鱙	堯	魚
鱚	喜	魚
鱛	曾	魚
鱜	鄉	魚
鱝	賁	魚
鱞	睘	魚
鱟	魚	𦥯
鱠	會	魚
鱡	賊	魚
鱢	喿	魚
鱣	亶	魚
鱤	感	魚
鱥	歲	魚
鱦	魚	黽
鱧	豊	魚
鱨	嘗	魚
鱩	雷	魚
鱪	暑	魚
鱫	愛	魚
鱬	需	魚
鱭	魚	齊
鱮	與	魚
鱯	蒦	魚
鱰	署	魚
鱱	厲	魚
鱲	巤	魚
鱳	樂	魚
鱴	蔑	魚
鱵	箴	魚
鱶	養	魚
鱷	噩	魚
鱸	盧	魚
鱹	雚	魚
鱺	魚	麗
鱻	䲆	魚
鱼	一	田	𠂊
鱽	刀	鱼
鱾	己	鱼
鱿	尤	鱼
鲀	屯	鱼
鲁	日	鱼
鲂	方	鱼
鲃	巴	鱼
鲄	可	鱼
鲅	犮	鱼
鲆	平	鱼
鲇	占	鱼
鲈	卢	鱼
鲉	由	鱼
鲊	乍	鱼
鲋	付	鱼
鲌	白	鱼
鲍	包	鱼
鲎	冖	鱼	𭕄
鲏	皮	鱼
鲐	台	鱼
鲑	圭	鱼
鲒	吉	鱼
鲓	考	鱼
鲔	有	鱼
鲕	而	鱼
鲖	同	鱼
鲗	则	鱼
鲘	后	鱼
鲙	会	鱼
鲚	鱼	齐
鲛	交	鱼
鲜	羊	鱼
鲝	羊	鱼
鲞	鱼	龹
鲟	寻	鱼
鲠	更	鱼
鲡	丽	鱼
鲢	连	鱼
鲣	坚	鱼
鲤	里	鱼
鲥	时	鱼
鲦	条	鱼
鲧	系	鱼
鲨	沙	鱼
鲩	完	鱼
鲪	君	鱼
鲫	即	鱼
鲬	甬	鱼
鲭	青	鱼
鲮	夌	鱼
鲯	其	鱼
鲰	取	鱼
鲱	非	鱼
鲲	昆	鱼
鲳	昌	鱼
鲴	固	鱼
鲵	兒	鱼
鲶	念	鱼
鲷	周	鱼
鲸	京	鱼
鲹	参	鱼
鲺	虱	鱼
鲻	甾	鱼
鲼	贲	鱼
鲽	枼	鱼
鲾	畐	鱼
鲿	尝	鱼
鳀	是	鱼
鳁	昷	鱼
鳂	畏	鱼
鳃	思	鱼
鳄	咢	鱼
鳅	秋	鱼
鳆	复	鱼
鳇	皇	鱼
鳈	泉	鱼
鳉	将	鱼
鳊	扁	鱼
鳋	蚤	鱼
鳌	敖	鱼
鳍	耆	鱼
鳎	鱼	𦐇
鳏	眔	鱼
鳐	䍃	鱼
鳑	旁	鱼
鳒	兼	鱼
鳓	勒	鱼
鳔	票	鱼
鳕	雪	鱼
鳖	敝	鱼
鳗	曼	鱼
鳘	敏	鱼
鳙	庸	鱼
鳚	尉	鱼
鳛	習	鱼
鳜	厥	鱼
鳝	善	鱼
鳞	粦	鱼
鳟	尊	鱼
鳠	蒦	鱼
鳡	感	鱼
鳢	豊	鱼
鳣	亶	鱼
鳤	管	鱼
鳥	⑦	灬
鳦	乙	鳥
鳧	几	鳥
鳨	力	鳥
鳩	九	鳥
鳪	卜	鳥
鳫	厂	鳥
鳬	⑦	几
鳭	刀	鳥
鳮	又	鳥
鳯	几	鳥
鳰	入	鳥
鳱	干	鳥
鳲	尸	鳥
鳳	几	𩾏
鳴	口	鳥
鳵	卂	鳥
鳶	弋	鳥
鳷	支	鳥
鳸	户	鳥
鳹	今	鳥
鳺	夫	鳥
鳻	分	鳥
鳼	文	鳥
鳽	开	鳥
鳾	帀	鳥
鳿	王	鳥
鴀	不	鳥
鴁	夭	鳥
鴂	夬	鳥
鴃	夬	鳥
鴄	匹	鳥
鴅	丹	鳥
鴆	冘	鳥
鴇	鳥	𠤏
鴈	厂	𠌵
鴉	牙	鳥
鴊	正	鳥
鴋	方	鳥
鴌	天	鳥
鴍	文	鳥
鴎	区	鳥
鴏	代	鳥
鴐	加	鳥
鴑	奴	鳥
鴒	令	鳥
鴓	必	鳥
鴔	乏	鳥
鴕	它	鳥
鴖	民	鳥
鴗	立	鳥
鴘	弁	鳥
鴙	矢	鳥
鴚	可	鳥
鴛	夗	鳥
鴜	此	鳥
鴝	句	鳥
鴞	号	鳥
鴟	氐	鳥
鴠	旦	鳥
鴡	且	鳥
鴢	幼	鳥
鴣	古	鳥
鴤	冬	鳥
鴥	穴	鳥
鴦	央	鳥
鴧	宂	鳥
鴨	甲	鳥
鴩	失	鳥
鴪	穴	鳥
鴫	田	鳥
鴬	冖	鳥	𭕄
鴭	鳥	𠂤
鴮	夸	鳥
鴯	而	鳥
鴰	舌	鳥
鴱	艾	鳥
鴲	旨	鳥
鴳	安	鳥
鴴	行	鳥
鴵	兆	鳥
鴶	吉	鳥
鴷	列	鳥
鴸	朱	鳥
鴹	羊	鳥
鴺	夷	鳥
鴻	䲨	氵
鴼	各	鳥
鴽	如	鳥
鴾	牟	鳥
鴿	合	鳥
鵀	任	鳥
鵁	交	鳥
鵂	休	鳥
鵃	舟	鳥
鵄	至	鳥
鵅	各	鳥
鵆	亍	彳	鳥
鵇	年	鳥
鵈	耳	鳥
鵉	亦	鳥
鵊	夾	鳥
鵋	忌	鳥
鵌	余	鳥
鵍	完	鳥
鵎	妥	鳥
鵏	甫	鳥
鵐	巫	鳥
鵑	肙	鳥
鵒	谷	鳥
鵓	孛	鳥
鵔	夋	鳥
鵕	夋	鳥
鵖	⑤	鳥
鵗	希	鳥
鵘	君	鳥
鵙	貝	鳥
鵚	秃	鳥
鵛	巠	鳥
鵜	弟	鳥
鵝	我	鳥
鵞	我	鳥
鵟	狂	鳥
鵠	告	鳥
鵡	武	鳥
鵢	身	鳥
鵣	束	鳥
鵤	角	鳥
鵥	判	鳥
鵦	录	鳥
鵧	并	鳥
鵨	舍	鳥
鵩	服	鳥
鵪	奄	鳥
鵫	卓	鳥
鵬	朋	鳥
鵭	金	鳥
鵮	臽	鳥
鵯	卑	鳥
鵰	周	鳥
鵱	坴	鳥
鵲	昔	鳥
鵳	肩	鳥
鵴	匊	鳥
鵵	兔	鳥
鵶	亞	鳥
鵷	宛	鳥
鵸	奇	鳥
鵹	鳥	𥝢
鵺	夜	鳥
鵻	隹	鳥
鵼	空	鳥
鵽	叕	鳥
鵾	昆	鳥
鵿	昇	鳥
鶀	其	鳥
鶁	京	鳥
鶂	兒	鳥
鶃	兒	鳥
鶄	青	鳥
鶅	甾	鳥
鶆	來	鳥
鶇	東	鳥
鶈	妻	鳥
鶉	享	鳥
鶊	庚	鳥
鶋	居	鳥
鶌	屈	鳥
鶍	易	鳥
鶎	宗	鳥
鶏	夫	爫	鳥
鶐	述	鳥
鶑	炏	鳥
鶒	勅	鳥
鶓	苗	鳥
鶔	柔	鳥
鶕	音	鳥
鶖	秋	鳥
鶗	是	鳥
鶘	胡	鳥
鶙	帝	鳥
鶚	咢	鳥
鶛	皆	鳥
鶜	茅	鳥
鶝	畐	鳥
鶞	盾	鳥
鶟	突	鳥
鶠	匽	鳥
鶡	曷	鳥
鶢	爰	鳥
鶣	扁	鳥
鶤	軍	鳥
鶥	眉	鳥
鶦	胡	鳥
鶧	英	鳥
鶨	彖	鳥
鶩	敄	鳥
鶪	狊	鳥
鶫	柬	鳥
鶬	倉	鳥
鶭	紡	鳥
鶮	高	鳥
鶯	鳥	𤇾
鶰	員	鳥
鶱	鳥	𡨄
鶲	翁	鳥
鶳	師	鳥
鶴	隺	鳥
鶵	芻	鳥
鶶	唐	鳥
鶷	害	鳥
鶸	弱	鳥
鶹	留	鳥
鶺	脊	鳥
鶻	骨	鳥
鶼	兼	鳥
鶽	隼	鳥
鶾	鳥	𠂉	𠦝
鶿	兹	鳥
鷀	兹	鳥
鷁	益	鳥
鷂	䍃	鳥
鷃	晏	鳥
鷄	奚	鳥
鷅	栗	鳥
鷆	眞	鳥
鷇	一	冖	士	殳	鳥
鷈	虒	鳥
鷉	虒	鳥
鷊	鬲	鳥
鷋	荼	鳥
鷌	馬	鳥
鷍	臬	鳥
鷎	皋	鳥
鷏	真	鳥
鷐	晨	鳥
鷑	笠	鳥
鷒	專	鳥
鷓	庶	鳥
鷔	敖	鳥
鷕	唯	鳥
鷖	殹	鳥
鷗	區	鳥
鷘	敕	鳥
鷙	執	鳥
鷚	翏	鳥
鷛	庸	鳥
鷜	婁	鳥
鷝	畢	鳥
鷞	爽	鳥
鷟	族	鳥
鷠	魚	鳥
鷡	無	鳥
鷢	厥	鳥
鷣	覃	鳥
鷤	單	鳥
鷥	絲	鳥
鷦	焦	鳥
鷧	壹	鳥
鷨	華	鳥
鷩	敝	鳥
鷪	䀠	冖	鳥
鷫	肅	鳥
鷬	鳥	黄
鷭	番	鳥
鷮	喬	鳥
鷯	尞	鳥
鷰	北	口	廿	鳥
鷱	臯	鳥
鷲	就	鳥
鷳	閒	鳥
鷴	閑	鳥
鷵	屠	鳥
鷶	買	鳥
鷷	尊	鳥
鷸	矞	鳥
鷹	䧹	鳥
鷺	路	鳥
鷻	敦	鳥
鷼	間	鳥
鷽	鳥	𦥯
鷾	意	鳥
鷿	辟	鳥
鸀	蜀	鳥
鸁	凡	吂	月	鳥
鸂	溪	鳥
鸃	義	鳥
鸄	敫	鳥
鸅	睪	鳥
鸆	虞	鳥
鸇	亶	鳥
鸈	業	鳥
鸉	楊	鳥
鸊	辟	鳥
鸋	寧	鳥
鸌	蒦	鳥
鸍	爾	鳥
鸎	賏	鳥
鸏	蒙	鳥
鸐	翟	鳥
鸑	獄	鳥
鸒	與	鳥
鸓	畾	鳥
鸔	暴	鳥
鸕	盧	鳥
鸖	霍	鳥
鸗	鳥	龍
鸘	霜	鳥
鸙	鳥	龠
鸚	嬰	鳥
鸛	雚	鳥
鸜	瞿	鳥
鸝	鳥	麗
鸞	䜌	鳥
鸟	④	一
鸠	九	鸟
鸡	又	鸟
鸢	弋	鸟
鸣	口	鸟
鸤	尸	鸟
鸥	区	鸟
鸦	牙	鸟
鸧	仓	鸟
鸨	鸟	𠤏
鸩	冘	鸟
鸪	古	鸟
鸫	东	鸟
鸬	卢	鸟
鸭	甲	鸟
鸮	号	鸟
鸯	央	鸟
鸰	令	鸟
鸱	氐	鸟
鸲	句	鸟
鸳	夗	鸟
鸴	冖	鸟	𭕄
鸵	它	鸟
鸶	丝	鸟
鸷	执	鸟
鸸	而	鸟
鸹	舌	鸟
鸺	休	鸟
鸻	行	鸟
鸼	舟	鸟
鸽	合	鸟
鸾	亦	鸟
鸿	江	鸟
鹀	巫	鸟
鹁	孛	鸟
鹂	丽	鸟
鹃	肙	鸟
鹄	告	鸟
鹅	我	鸟
鹆	谷	鸟
鹇	闲	鸟
鹈	弟	鸟
鹉	武	鸟
鹊	昔	鸟
鹋	苗	鸟
鹌	奄	鸟
鹍	昆	鸟
鹎	卑	鸟
鹏	朋	鸟
鹐	臽	鸟
鹑	享	鸟
鹒	庚	鸟
鹓	宛	鸟
鹔	肃	鸟
鹕	胡	鸟
鹖	曷	鸟
鹗	咢	鸟
鹘	骨	鸟
鹙	秋	鸟
鹚	兹	鸟
鹛	眉	鸟
鹜	敄	鸟
鹝	鬲	鸟
鹞	䍃	鸟
鹟	翁	鸟
鹠	留	鸟
鹡	脊	鸟
鹢	益	鸟
鹣	兼	鸟
鹤	隺	鸟
鹥	殹	鸟
鹦	婴	鸟
鹧	庶	鸟
鹨	翏	鸟
鹩	尞	鸟
鹪	焦	鸟
鹫	就	鸟
鹬	矞	鸟
鹭	路	鸟
鹮	睘	鸟
鹯	亶	鸟
鹰	䧹	鸟
鹱	蒦	鸟
鹲	蒙	鸟
鹳	雚	鸟
鹴	霜	鸟
鹵	⺊	囗	𠂭
鹶	今	鹵
鹷	令	鹵
鹸	㑒	鹵
鹹	咸	鹵
鹺	差	鹵
鹻	兼	鹵
鹼	僉	鹵
鹽	皿	臣	鹵	𠂉
鹾	卤	差
鹿	コ	丨	广	比
麀	匕	鹿
麁	鹿	𠂊
麂	几	鹿
麃	灬	鹿
麄	分	鹿
麅	包	鹿
麆	且	鹿
麇	禾	鹿
麈	主	鹿
麉	幵	鹿
麊	米	鹿
麋	米	鹿
麌	吴	鹿
麍	㐬	鹿
麎	辰	鹿
麏	君	鹿
麐	吝	鹿
麑	兒	鹿
麒	其	鹿
麓	林	鹿
麔	咎	鹿
麕	囷	鹿
麖	京	鹿
麗	鹿	丽
麘	香	鹿
麙	咸	鹿
麚	叚	鹿
麛	弭	鹿
麜	栗	鹿
麝	射	鹿
麞	章	鹿
麟	粦	鹿
麠	畺	鹿
麡	鹿	齊
麢	霝	鹿
麣	嚴	鹿
麤	鹿
麥	來	夂
麦	夂	龶
麧	乞	麥
麨	少	麥
麩	夫	麥
麪	丏	麥
麫	丐	麥
麬	皮	麥
麭	包	麥
麮	去	麥
麯	曲	麥
麰	牟	麥
麱	甫	麥
麲	見	麥
麳	來	麥
麴	匊	麥
麵	面	麥
麶	离	麥
麷	豐	麥
麸	夫	麦
麹	匊	麦
麺	面	麦
麻	广	林
麼	幺	麻
麽	么	麻
麾	毛	麻
麿	吕	麻
黀	取	麻
黁	香	麻
黂	賁	麻
黃	一	八	廿	由
黄	八	由	龷
黅	今	黄
黆	冘	黄
黇	占	黄
黈	主	黄
黉	冖	黄	𭕄
黊	圭	黄
黋	光	黄
黌	黄	𦥯
黍	人	氺	禾
黎	人	氺	𥝢
黏	占	黍
黐	离	黍
黑	⑧	灬
黒	灬	里
黓	弋	黑
黔	今	黑
黕	冘	黑
黖	旡	黑
黗	屯	黑
默	犬	黑
黙	灬	犬	里
黚	甘	黑
黛	代	黑
黜	出	黑
黝	幼	黑
點	占	黑
黟	多	黑
黠	吉	黑
黡	厌	黑
黢	夋	黑
黣	每	黑
黤	奄	黑
黥	京	黑
黦	宛	黑
黧	黑	𥝢
黨	黑	𫩠
黩	卖	黑
黪	参	黑
黫	垔	黑
黬	咸	黑
黭	弇	黑
黮	甚	黑
黯	音	黑
黰	真	黑
黱	月	黑	龹
黲	參	黑
黳	殹	黑
黴	彳	𪑛
黵	詹	黑
黶	厭	黑
黷	賣	黑
黸	盧	黑
黹	㡀	业
黺	分	黹
黻	犮	黹
黼	甫	黹
黽	黽
黾	口	电
黿	元	黽
鼀	圥	黽
鼁	去	黽
鼂	旦	黽
鼃	圭	黽
鼄	朱	黽
鼅	知	黽
鼆	冥	黽
鼇	敖	黽
鼈	敝	黽
鼉	㽞	一	黽
鼊	辟	黽
鼋	元	黾
鼌	旦	黾
鼍	㽞	一	黾
鼎	⑧	目
鼏	冖	鼎
鼐	乃	鼎
鼑	⺊	鼎
鼒	才	鼎
鼓	壴	支
鼔	壴	攴
鼕	冬	鼓
鼖	卉	鼓
鼗	兆	鼓
鼘	鼓	𣶒
鼙	卑	鼓
鼚	長	鼓
鼛	咎	鼓
鼜	蚤	鼓
鼝	淵	鼓
鼞	堂	鼓
鼟	登	鼓
鼠	⑦	臼
鼡	𠂡	𭕄
鼢	分	鼠
鼣	犬	鼠
鼤	文	鼠
鼥	犮	鼠
鼦	召	鼠
鼧	它	鼠
鼨	冬	鼠
鼩	句	鼠
鼪	生	鼠
鼫	石	鼠
鼬	由	鼠
鼭	寺	鼠
鼮	廷	鼠
鼯	吾	鼠
鼰	貝	鼠
鼱	青	鼠
鼲	軍	鼠
鼳	狊	鼠
鼴	匽	鼠
鼵	突	鼠
鼶	虒	鼠
鼷	奚	鼠
鼸	兼	鼠
鼹	晏	鼠
鼺	畾	鼠
鼻	畀	自
鼼	丩	鼻
鼽	九	鼻
鼾	干	鼻
鼿	兀	鼻
齀	瓦	鼻
齁	句	鼻
齂	隶	鼻
齃	曷	鼻
齄	查	鼻
齅	臭	鼻
齆	邕	鼻
齇	虘	鼻
齈	農	鼻
齉	囊	鼻
齊	③	丨	丫	丿	二	亠	刀
齋	小	齊
齌	火	齊
齍	皿	齊
齎	貝	齊
齏	韭	齊
齐	丨	丿	文
齑	韭	齐
齒	止	𠚕
齓	乚	齒
齔	匕	齒
齕	乞	齒
齖	牙	齒
齗	斤	齒
齘	介	齒
齙	包	齒
齚	乍	齒
齛	世	齒
齜	此	齒
齝	台	齒
齞	只	齒
齟	且	齒
齠	召	齒
齡	令	齒
齢	令	歯
齣	句	齒
齤	齒	龹
齥	曳	齒
齦	艮	齒
齧	㓞	齒
齨	臼	齒
齩	交	齒
齪	足	齒
齫	困	齒
齬	吾	齒
齭	所	齒
齮	奇	齒
齯	兒	齒
齰	昔	齒
齱	取	齒
齲	禹	齒
齳	軍	齒
齴	彦	齒
齵	禺	齒
齶	咢	齒
齷	屋	齒
齸	益	齒
齹	差	齒
齺	芻	齒
齻	真	齒
齼	楚	齒
齽	禁	齒
齾	獻	齒
齿	齿
龀	匕	齿
龁	乞	齿
龂	斤	齿
龃	且	齿
龄	令	齿
龅	包	齿
龆	召	齿
龇	此	齿
龈	艮	齿
龉	吾	齿
龊	足	齿
龋	禹	齿
龌	屋	齿
龍	⑦	𦚏
龎	厂	龍
龏	廾	龍
龐	广	龍
龑	天	龍
龒	示	龍
龓	有	龍
龔	共	龍
龕	合	龍
龖	龍
龗	霝	龍
龘	龍	龖
龙	丿	尤
龚	共	龙
龛	合	龙
龜	龜
龝	禾	龜
龞	敝	龜
龟	乚	日	𠂊
龠	亼	𠕁	𠱠
龡	欠	龠
龢	禾	龠
龣	录	龠
龤	皆	龠
龥	頁	龠
龦	常	火
龧	日	暑
龨	匚	隹
龩	艹	靳
龪	人	走
龫	車	𫢉
龬	罔	金
龭	異	馬
龮	翼	馬
龯	戊	金
龰	龰
龱	㐅	囗
龲	庫	金
龳	坴
龴	龴
龵	龵
龶	龶
龷	一	卄
龸	⺌	冖
龹	丷	夫
龺	十	早
龻	糸	言
龼	土	睿
龽	火	魚
龾	匊	皮
龿	佳	艹
鿀	艹	醫
鿁	共	言
鿂	車	鳥
鿃	㚒	目
鿄	㲽	木
鿅	礻	零
鿆	友	礻
鿇	争	亻
鿈	尺	彳
鿉	五	彳
鿊	沚	艹
鿋	喜	衤
鿌	亰	氵
鿍	土	夅
鿎	石	达
鿏	钅	麦
鿐	酒	魚
鿑	冫	玉
鿒	艹	页
鿓	艹	頁
鿔	哥	钅
鿕	丹	鱼
鿖	一	合
鿗	一	人	伊
鿘	伊	合
鿙	伊	克
鿚	伊	格
鿛	凌	爾
鿜	拉	爾
鿝	楞	爾
鿞	列	爾
鿟	利	尔
鿠	利	爾
鿡	爾	羅
鿢	合	耶
鿣	克	耶
鿤	格	耶
鿥	爾	郎
鿦	微	英
鿧	爾	隆
鿨	爾	雷
鿩	爾	魯
鿪	灬	遂
鿫	奥	气
鿬	田	石
鿭	尔	钅
鿮	帯	广
鿯	人	物	米
㐀	一	卝
㐁	㐁
㐂	七
㐃	△	丨
㐄	㐄
㐅	㐅
㐆	㐆
㐇	乙	九
㐈	乙	入
㐉	丁	乙
㐊	乙	士
㐋	乙	土
㐌	也	𠂉
㐍	乙	爫
㐎	乙	文
㐏	乙	五
㐐	乙	奴
㐑	乙	冬
㐒	乙	召
㐓	乙	可
㐔	乙	亠	口
㐕	乙	由
㐖	乚	吉
㐗	乙	老
㐘	乙	米
㐙	乙	豆
㐚	乙	吾
㐛	乙	佑
㐜	九	求
㐝	乙	拘
㐞	乙	其
㐟	乙	非
㐠	乙	乳
㐡	九	耎
㐢	乙	浮
㐣	乙	庫
㐤	九	真
㐥	乙	鋤
㐦	乙	擧
㐧	㐧
㐨	予
㐩	井
㐪	亠	人	凵
㐫	亠	凶
㐬	𠫓	𫶧
㐭	亠	回
㐮	六	𠀎	𧘇
㐯	亠	吕	香
㐰	亻	口
㐱	人	彡
㐲	亻	大
㐳	亻	兀
㐴	亻	夕
㐵	于	亻
㐶	亻	巳
㐷	亻	马
㐸	亻	欠
㐹	亻	气
㐺	亻	𠆧
㐻	亻	内
㐼	亻	升
㐽	亻	风
㐾	亻	元
㐿	亻	手
㑀	亻	太
㑁	亻	出
㑂	丙	亻
㑃	亻	幼
㑄	亻	母
㑅	上	亻	𠂉
㑆	亻	兄
㑇	亻	刍
㑈	东	亻
㑉	亻	夙
㑊	亦	亻
㑋	亻	曲
㑌	亻	匡
㑍	亻	耒
㑎	亻	𭗼
㑏	亻	守
㑐	亻	尗
㑑	亻	自
㑒	人	亼	口
㑓	亻	𭆙
㑔	亻	页
㑕	亻	岁
㑖	亻	仲
㑗	亻	身
㑘	亻	戒
㑙	亻	𦔮
㑚	亻	那
㑛	亻	束
㑜	亻	折
㑝	亻	弄
㑞	亻	灷
㑟	亻	兵
㑠	亻	坚
㑡	亻	即
㑢	亻	却
㑣	亻	林
㑤	亻	苗
㑥	亻	易
㑦	亻	戾
㑧	亻	季
㑨	亻	口	矢
㑩	亻	罗
㑪	亻	斉
㑫	亻	念
㑬	亻	姑
㑭	亻	畀
㑮	亻	軍
㑯	亻	頁
㑰	亻	彖
㑱	亻	柔
㑲	亻	南
㑳	亻	芻
㑴	亻	又	帚
㑵	亻	疾
㑶	亻	氣
㑷	亻	能
㑸	亻	古	可
㑹	亼	曰	由
㑺	亻	隽
㑻	亻	密
㑼	亻	略
㑽	亻	堂
㑾	䚻	亻
㑿	亻	巢
㒀	亻	啇
㒁	亻	圉
㒂	亻	著
㒃	亻	貳
㒄	亻	然
㒅	亻	袲
㒆	亻	翕
㒇	亻	無
㒈	亻	敢
㒉	亻	棠
㒊	亻	歰
㒋	亻	斯
㒌	亻	焭
㒍	亻	絫
㒎	䨿	亻
㒏	亻	寒
㒐	亻	筍
㒑	亻	匯
㒒	亻	業
㒓	亻	達
㒔	亻	蜀
㒕	亻	雍
㒖	亻	萬
㒗	䑓	亻
㒘	亻	竪
㒙	亻	綿
㒚	㥯	亻
㒛	亻	翟
㒜	亻	與
㒝	亻	蔑
㒞	亻	嶲
㒟	亻	褭
㒠	亻	韰
㒡	亻	繇
㒢	亻	龠
㒣	亻	應
㒤	亻	聶
㒥	亻	豐
㒦	亻	壘
㒧	亻	離
㒨	亻	巳	𦦉
㒩	亻	蠡
㒪	人	止	豕	𦣦
㒫	④	儿
㒬	元	王
㒭	兄
㒮	元	豕
㒯	光	華
㒰	入	工
㒱	入	夕
㒲	入	日
㒳	丨	冂	𠓜
㒴	入	出
㒵	八	白
㒶	八	白
㒷	一	八	𠔿
㒸	丷	豕
㒹	真
㒺	䒑	亾	冂
㒻	冃	見
㒼	巾	廿	𠓜
㒽	冃	卷
㒾	冃	施
㒿	冃	離
㓀	冖	卜
㓁	儿	冖
㓂	元	冖	女
㓃	冖	託
㓄	冘	參
㓅	丁	冫
㓆	仑	冫
㓇	冫	夭
㓈	冫	石
㓉	冫	舌
㓊	冫	同
㓋	共	冫
㓌	全	冫
㓍	充	冫
㓎	冫	𠬶
㓏	冏	冫
㓐	冫	坴
㓑	冫	幸
㓒	七	冫	𠇍
㓓	冫	南
㓔	冫	射
㓕	冫	烕
㓖	冫	畢
㓗	冫	絜
㓘	夙	玉
㓙	凵	文
㓚	刂	工
㓛	刀	工
㓜	刀	幺
㓝	井	刂
㓞	丰	刀
㓟	刂	皮
㓠	刂	占
㓡	刂	缶
㓢	刂	各
㓣	刂	合
㓤	刂	吉
㓥	刂	当
㓦	刂	百
㓧	刂	含
㓨	刂	夾
㓩	刂	角
㓪	刀	良
㓫	刂	大	开
㓬	刂	券
㓭	刂	曷
㓮	刂	周
㓯	刂	甾
㓰	刂	画
㓱	俞	刂
㓲	刂	扁
㓳	刂	是
㓴	刂	耎
㓵	刂	咢
㓶	刂	契
㓷	刂	臬
㓸	刂	𠁁
㓹	刂	厂	炎
㓺	刂	虔
㓻	刂	罡
㓼	刂	桼
㓽	刂	崇
㓾	刂	犀
㓿	刂	黍
㔀	刂	景
㔁	刂	登
㔂	刂	粦
㔃	刀	絶
㔄	刂	粟
㔅	刂	肅
㔆	刂	朁
㔇	刂	發
㔈	刂	菲
㔉	刂	属
㔊	亶	刂
㔋	刂	監
㔌	刂	聚
㔍	刂	算
㔎	刀	辥
㔏	刂	磊
㔐	一	刂	竹	韭
㔑	刀	薛
㔒	刂	巂
㔓	力	千
㔔	㇣	加
㔕	力	气
㔖	加	𠃍
㔗	力	弗
㔘	出	力
㔙	力	并
㔚	力	舌
㔛	力	吉
㔜	力	孚
㔝	兩	力
㔞	乖	力
㔟	力	𭺳
㔠	力	曷
㔡	力	𣬉
㔢	力	絶
㔣	力	畾
㔤	力	審
㔥	力	罷
㔦	力	養
㔧	力	盧
㔨	勹	背
㔩	勹	盍
㔪	勹	鹵
㔫	匕	𠂇
㔬	匕	早
㔭	匕	是
㔮	口	夫	廿	能
㔯	匚	口	𠘧
㔰	匚	外
㔱	匚	臾
㔲	九	匚	飠
㔳	匚	飢
㔴	匚	異
㔵	匚	巽
㔶	匚	贛
㔷	丙	匚
㔸	匚	虒
㔹	力	十
㔺	一	乚	十
㔻	不	十
㔼	十	推
㔽	⺊	回
㔾	㔾
㔿	一	丩
㕀	㔾	由
㕁	卩	𠫤
㕂	今	厂
㕃	厂	开
㕄	厂	𢆰
㕅	厂	甲
㕆	厂	古
㕇	厂	立
㕈	厂	衣
㕉	厂	合
㕊	厂	甫
㕋	厂	金
㕌	㝵	厂
㕍	厂	隹
㕎	厂	盍
㕏	㪷	厂
㕐	厂	舄
㕑	厂	尌
㕒	厂	義
㕓	厂	墨
㕔	厂	聽
㕕	厶
㕖	厽	木
㕗	厶	羑
㕘	小	𠫯
㕙	兔	夋
㕚	丶	叉
㕛	又
㕜	中	又
㕝	又	古
㕞	又	𡰯
㕟	⺊	又	𠕁
㕠	准	又
㕡	䜭	又
㕢	又	貝	𣦵
㕣	八	口
㕤	九	口
㕥	人	口
㕦	口	大
㕧	口	尸
㕨	凡	口
㕩	丰	口
㕪	冘	口
㕫	口	方
㕬	公	口
㕭	口	夭
㕮	口	父
㕯	内	口
㕰	口	毛
㕱	口	尤
㕲	口	木
㕳	凶	口
㕴	冗	口
㕵	口	王
㕶	五	口
㕷	口	白
㕸	口	立
㕹	口	犮
㕺	丂	吅
㕻	丶	否
㕼	㐅	勹	口	𠃊
㕽	以	口
㕾	叱	小
㕿	口	禾
㖀	口	聿
㖁	口	𠫤
㖂	口	曳
㖃	口	后
㖄	口	州
㖅	口	戌
㖆	口	曲
㖇	口	而
㖈	口	老
㖉	企	口
㖊	口	寻
㖋	介	叱
㖌	仇	叱
㖍	叱	斗
㖎	介	叱
㖏	口	圼
㖐	吅	尹
㖑	口	戒
㖒	口	弟
㖓	口	夆
㖔	口	吞
㖕	口	辛
㖖	口	辛
㖗	口	岑
㖘	口	辰
㖙	加	叱
㖚	付	叱
㖛	古	叱
㖜	亠	口	叱
㖝	叱	未
㖞	口	呙
㖟	受	口
㖠	口	奈
㖡	口	夜
㖢	口	庛
㖣	口	咅
㖤	函	口
㖥	口	囷
㖦	口	東
㖧	口	昏
㖨	口	录
㖩	取	口
㖪	口	或
㖫	口	夌
㖬	口	𪠨
㖭	口	忝
㖮	侖	口
㖯	叱	同
㖰	叱	同
㖱	口	夜
㖲	叱	如
㖳	叱	汝
㖴	口	芴
㖵	具	口
㖶	口	垔
㖷	口	是
㖸	口	虐
㖹	口	盆
㖺	口	春
㖻	口	柔
㖼	口	某
㖽	口	頁
㖾	吅	屰
㖿	口	耶
㗀	口	幽
㗁	口	咢
㗂	口	省
㗃	口	昬
㗄	口	𬙙
㗅	口	胡
㗆	口	革
㗇	叚	口
㗈	勇	口
㗉	㓞	各
㗊	吅
㗋	口	矦
㗌	口	室
㗍	口	香
㗎	口	架
㗏	口	歪
㗐	口	盇
㗑	口	拜
㗒	口	哀
㗓	口	追
㗔	口	虔
㗕	冓	口
㗖	口	舀
㗗	卑	另
㗘	口	尃
㗙	口	芻
㗚	口	栗
㗛	口	笑
㗜	口	畜
㗝	口	羔
㗞	口	破
㗟	叱	注
㗠	叱	始
㗡	艹	𪝁
㗢	動	口
㗣	口	帶
㗤	口	戚
㗥	口	郭
㗦	口	聊
㗧	口	窒
㗨	口	殹
㗩	口	習
㗪	口	紫
㗫	口	祭
㗬	多	𫩠
㗭	口	悉
㗮	名	庚
㗯	叱	者
㗰	口	從
㗱	口	集
㗲	口	畫
㗳	口	答
㗴	口	閒
㗵	口	欻
㗶	口	發
㗷	口	宀	贝	𠀎
㗸	䘖	口
㗹	口	𢛧
㗺	䨿	口
㗻	口	過
㗼	口	業
㗽	口	鄉
㗾	口	靴
㗿	口	閜
㘀	䊆	口
㘁	口	睪
㘂	口	慈
㘃	口	惹
㘄	口	楞
㘅	口	銜
㘆	口	臺
㘇	口	榮
㘈	口	疑
㘉	口	節
㘊	口	霅
㘋	口	賢
㘌	劇	口
㘍	口	𢧵
㘎	口	阚
㘏	叱	道
㘐	口	駮
㘑	口	隷
㘒	叱	種
㘓	口	闌
㘔	口	賽
㘕	口	藍
㘖	口	顔
㘗	口	瞿
㘘	䜌	口
㘙	口	嚴
㘚	口	闞
㘛	口	龕
㘜	口	讎
㘝	又	囗
㘞	力	囗
㘟	囗	廾
㘠	囗	必
㘡	囗	甲
㘢	光	囗
㘣	囗	肙
㘤	囗	淵
㘥	囗	繇
㘦	力	土
㘧	予	土
㘨	内	土
㘩	土	比
㘪	土	毛
㘫	井	土
㘬	勾	土
㘭	土	幻
㘮	土	尺
㘯	力	土	𠂉
㘰	土	斗
㘱	冉	土
㘲	土	尻
㘳	北	土
㘴	㕥	土
㘵	土	布
㘶	土	舛
㘷	土	艾
㘸	土	死
㘹	土	此
㘺	伐	土
㘻	因	土
㘼	土	考
㘽	土	𢦏
㘾	土	宇
㘿	土	圼
㙀	土	究
㙁	土	每
㙂	兑	土
㙃	兵	土
㙄	土	坒
㙅	呆	土
㙆	土	宏
㙇	土	豖
㙈	土	虎
㙉	典	土
㙊	土	長
㙋	其	土
㙌	土	肃
㙍	叕	土
㙎	土	威
㙏	土	复
㙐	土	耑
㙑	土	禹
㙒	土	𤰩
㙓	土	垚
㙔	土	韋
㙕	土	胃
㙖	土	禹
㙗	土	畏
㙘	土	要
㙙	土	浝
㙚	土	牛	𦍌
㙛	土	尃
㙜	土	高
㙝	土	脅
㙞	土	臬
㙟	土	朗
㙠	土	殹
㙡	土	從
㙢	㒼	土
㙣	土	張
㙤	土	虖
㙥	土	袞
㙦	土	斜
㙧	土	畱
㙨	土	幾
㙩	土	尞
㙪	土	壹
㙫	土	集
㙬	土	猌
㙭	厥	土
㙮	土	答
㙯	云	埶
㙰	土	解
㙱	土	號
㙲	土	雍
㙳	土	感
㙴	土	詹
㙵	㙜	土
㙶	亠	口	堂
㙷	㬎	土
㙸	僕	土
㙹	土	夢
㙺	匱	土
㙻	土	廛
㙼	土	畾
㙽	土	奭
㙾	土	學
㙿	土	羲
㚀	土	戲
㚁	堯
㚂	囊	土
㚃	䒑	冖	凶	士
㚄	冖	士	田	疋
㚅	夂	𤯔
㚆	夂	𣅀
㚇	八	凶	夂
㚈	十	夕
㚉	乃	多
㚊	亥	多
㚋	周	多
㚌	多	果
㚍	多	貴
㚎	凵	大
㚏	大	廾
㚐	大
㚑	コ	一	大
㚒	大	𠓜
㚓	大	木
㚔	大	𢆉
㚕	大	弗
㚖	大	白
㚗	且	大
㚘	夫
㚙	加	大
㚚	名	大
㚛	大	旨
㚜	大	或
㚝	佳	大
㚞	大	林
㚟	㲋	大
㚠	大	羔
㚡	奇
㚢	亻	女
㚣	女
㚤	女	弋
㚥	于	女
㚦	丌	女
㚧	女	广
㚨	卂	女
㚩	冄	女
㚪	女	毛
㚫	及	女
㚬	勻	女
㚭	女	尤
㚮	冗	女
㚯	女	风
㚰	丕	女
㚱	丘	女
㚲	占	女
㚳	加	女
㚴	女	布
㚵	冬	女
㚶	㠯	女
㚷	女	尒
㚸	司	女
㚹	卯	女
㚺	女	孕
㚻	女	田
㚼	女	田
㚽	女	巧
㚾	兄	女
㚿	包	女
㛀	刍	女
㛁	女	平
㛂	女	𠂬
㛃	㓞	女
㛄	女	衣
㛅	女	耳
㛆	女	朶
㛇	女	庄
㛈	女	考
㛉	女	覀
㛊	女	朵
㛋	女	𠇍
㛌	女	牟
㛍	夾	女
㛎	呂	女
㛏	女	求
㛐	女	更
㛑	女	𣦼
㛒	女	豆
㛓	女	希
㛔	夆	女
㛕	女	邑
㛖	夋	女
㛗	坐	女
㛘	女	孛
㛙	女	辛
㛚	女	甬
㛛	女	身
㛜	女	攸
㛝	女	貝
㛞	女	弄
㛟	奂	女
㛠	女	间
㛡	女	完
㛢	女	秀
㛣	员	女
㛤	丽	女
㛥	女	沓
㛦	女	林
㛧	女	岩
㛨	女	羌
㛩	女	育
㛪	奄	女
㛫	女	易
㛬	坴	女
㛭	女	昔
㛮	叜	女
㛯	勉	女
㛰	女	昬
㛱	女	畏
㛲	女	頁
㛳	女	帝
㛴	女	𡿺
㛵	女	爯
㛶	女	炭
㛷	女	𮂱
㛸	壴	女
㛹	便	女
㛺	女	音
㛻	奎	女
㛼	女	臿
㛽	女	宩
㛾	咸	女
㛿	女	带
㜀	女	相
㜁	女	查
㜂	女	封
㜃	信	女
㜄	女	風
㜅	女	畜
㜆	女	迷
㜇	女	恚
㜈	務	女
㜉	女	邕
㜊	女	展
㜋	女	益
㜌	一	冖	士	女	殳
㜍	唐	女
㜎	奚	女
㜏	員	女
㜐	女	豈
㜑	女	浦
㜒	女	舁
㜓	女	荅
㜔	女	竞
㜕	女	連
㜖	女	曹
㜗	參	女
㜘	女	虘
㜙	女	鹿
㜚	女	宿
㜛	女	軟
㜜	女	敖
㜝	女	酓
㜞	女	斬
㜟	女	敢
㜠	女	崔
㜡	女	從
㜢	女	婁
㜣	女	然
㜤	女	覃
㜥	女	買
㜦	女	尋
㜧	厥	女
㜨	女	犀
㜩	奧	女
㜪	女	新
㜫	女	微
㜬	女	詹
㜭	女	當
㜮	女	監
㜯	女	熙
㜰	女	樂
㜱	女	質
㜲	女	嬴
㜳	女	褱
㜴	女	瞢
㜵	女	褭
㜶	女	毚
㜷	女	彌
㜸	女	薛
㜹	女	瞿
㜺	女	贊
㜻	女	戀
㜼	女	疊
㜽	子	巛
㜾	介	子
㜿	予	子
㝀	子	母
㝁	子	旬
㝂	子	折
㝃	免	子
㝄	享	屯
㝅	殳	𫯂
㝆	喜	子
㝇	享
㝈	䜌	孖
㝉	一	宀
㝊	又	宀
㝋	了	宀
㝌	久	宀
㝍	与	宀
㝎	之	宀
㝏	介	宀
㝐	公	宀
㝑	宀	方
㝒	古	宀
㝓	合	宀
㝔	交	宀
㝕	又	𫲽
㝖	多	宀
㝗	宀	良
㝘	宀	言
㝙	一	八	宀	王
㝚	宀	延
㝛	宀	𠈇
㝜	宀	昔
㝝	宀	林
㝞	亞	宀
㝟	㝉	見
㝠	宀	昗
㝡	取	宀
㝢	宀	禹
㝣	契	宀
㝤	冓	宀
㝥	宀	爿	米
㝦	宀	隽
㝧	坐	安
㝨	宀	袁
㝩	宀	康
㝪	執	宀
㝫	宀	隆
㝬	夫	害
㝭	宀	惺
㝮	宀	𠭥
㝯	喬	宀
㝰	宀	臱
㝱	夢	宀	爿
㝲	冖	宀	帚	爿	罒	艹
㝳	㣺	一
㝴	元	寸
㝵	寸	旦
㝶	儿	寸	罒
㝷	丸	寸	工	彐
㝸	小	皃
㝹	兔	少
㝺	兼	少
㝻	堇	少
㝼	于	尢
㝽	尢	水
㝾	尢	左
㝿	尢	皮
㞀	尢	灰
㞁	㫐	尢
㞂	妥	尢
㞃	尤	谷
㞄	奄	尢
㞅	尢	果
㞆	奇	尢
㞇	尢	畏
㞈	尢	扁
㞉	尢	差
㞊	尢	祟
㞋	又	尸
㞌	子	尸
㞍	丸	尸
㞎	尸	巴
㞏	乏	尸
㞐	尸	立
㞑	丷	乚	八	尸
㞒	尸	自
㞓	尸	旨
㞔	多	尸
㞕	䏌	尸
㞖	尸	朿
㞗	尸	求
㞘	尸	豖
㞙	尾	水
㞚	尸	臿
㞛	尸	彳	旨
㞜	㣦	尸
㞝	尸	戚
㞞	尸	從
㞟	奠	尸
㞠	尞	尸
㞡	㠭	尸	𧘇
㞢	一	屮
㞣	分	屮
㞤	人	山
㞥	入	山
㞦	几	山
㞧	乃	山
㞨	子	山
㞩	凡	山
㞪	山	彐
㞫	之	山
㞬	山	工
㞭	大	山
㞮	山	𠚤
㞯	山	己
㞰	午	山
㞱	山	日
㞲	中	山
㞳	山	斗
㞴	山	氏
㞵	山	文
㞶	山	文
㞷	屮	王
㞸	不	山
㞹	可	山
㞺	山	矢
㞻	号	山
㞼	山	氶
㞽	山	戉
㞾	尼	山
㞿	乂	土	山
㟀	山	禾
㟁	厈	山
㟂	山	母
㟃	司	山
㟄	山	羊
㟅	兇	山
㟆	华	山
㟇	坐	山
㟈	山	求
㟉	山	牢
㟊	孚	山
㟋	兑	山
㟌	尨	山
㟍	山	良
㟎	妥	山
㟏	含	山
㟐	山	芒
㟑	孛	山
㟒	君	山
㟓	山	希
㟔	含	山
㟕	呌	山
㟖	山	弄
㟗	分	山
㟘	周	山
㟙	山	昔
㟚	山	枝
㟛	山	拑
㟜	山	弥
㟝	咅	山
㟞	山	戔
㟟	山	巷
㟠	山	岡
㟡	卷	山
㟢	奇	山
㟣	山	松
㟤	山	录
㟥	参	山
㟦	山	軍
㟧	咢	山
㟨	山	耑
㟩	山	敃
㟪	山	畏
㟫	山	泉
㟬	叟	山
㟭	山	昬
㟮	山	突
㟯	客	山
㟰	冥	山
㟱	山	羔
㟲	原	山
㟳	山	栗
㟴	山	鬼
㟵	山	罡
㟶	原	山
㟷	山	荅
㟸	山	皋
㟹	山	聊
㟺	婁	山
㟻	山	斬
㟼	山	敖
㟽	山	票
㟾	山	庸
㟿	山	莽
㠀	山	鳥
㠁	參	山
㠂	山	敖
㠃	啇	山
㠄	山	習
㠅	山	復
㠆	單	山
㠇	就	山
㠈	山	閏
㠉	山	童
㠊	山	虛
㠋	亏	品	山
㠌	山	欺
㠍	山	集
㠎	山	集
㠏	山	華
㠐	喬	山
㠑	山	罪
㠒	剽	山
㠓	山	蒙
㠔	山	辟
㠕	山	隗
㠖	山	義
㠗	奧	山
㠘	山	與
㠙	山	豪
㠚	對	山
㠛	山	蒦
㠜	山	疑
㠝	山	賛
㠞	山	徵
㠟	山	黎
㠠	山	盧
㠡	山	褭
㠢	嵬	衣
㠣	山	歷
㠤	山	襄
㠥	壘	山
㠦	山	豐
㠧	山	靡
㠨	山	欝
㠩	亾	𫶧
㠪	一	上
㠫	夫	巩
㠬	口	夫	工
㠭	工
㠮	工	普
㠯	㠯
㠰	加	己
㠱	其	己
㠲	匕	巾
㠳	入	巾
㠴	刃	巾
㠵	亡	巾
㠶	凢	巾
㠷	及	巾
㠸	夫	巾
㠹	介	巾
㠺	少	巾
㠻	巾	耂
㠼	巾	斤
㠽	冬	巾
㠾	夗	巾
㠿	巾	此
㡀	丷	八	巾
㡁	夸	巾
㡂	列	巾
㡃	㠩	巾
㡄	巾	旬
㡅	多	巾
㡆	巟	巾
㡇	巾	𦔮
㡈	免	巾
㡉	巾	弦
㡊	巾	臽
㡋	奄	巾
㡌	冐	巾
㡍	㚖	巾
㡎	参	巾
㡏	俞	巾
㡐	前	巾
㡑	巾	秋
㡒	巾	盾
㡓	巾	軍
㡔	巾	敄
㡕	巾	英
㡖	巾	重
㡗	巾	虒
㡘	兼	巾
㡙	巾	𣬉
㡚	冓	巾
㡛	巾	荒
㡜	巾	祭
㡝	巾	逢
㡞	婁	巾
㡟	巾	曹
㡠	巾	登
㡡	厨	巾
㡢	巾	𭦟
㡣	⑦	帝
㡤	巾	業
㡥	㥯	巾
㡦	巾	賓
㡧	䆸	巾
㡨	巾	韱
㡩	䜌	巾
㡪	巾	𤔿
㡫	幺	曷
㡬	成	𢆶
㡭	𢆸
㡮	幾	气
㡯	乇	广
㡰	于	广
㡱	久	广
㡲	广	戈
㡳	广	氏
㡴	广	立
㡵	令	广
㡶	只	广
㡷	广	本
㡸	乍	广
㡹	且	广
㡺	广	旦
㡻	卯	广
㡼	广	曳
㡽	广	聿
㡾	广	艮
㡿	屰	广
㢀	广	朿
㢁	多	广
㢂	广	𠂤
㢃	广	良
㢄	广	豆
㢅	广	弄
㢆	广	里
㢇	广	言
㢈	广	隹
㢉	广	秅
㢊	奇	广
㢋	侈	广
㢌	广	阿
㢍	广	英
㢎	广	臿
㢏	俞	广
㢐	咼	广
㢑	广	隼
㢒	广	虘
㢓	广	章
㢔	广	從
㢕	乡	广	隹
㢖	广	番
㢗	喬	广
㢘	广	𠔥
㢙	勤	广
㢚	广	虜
㢛	僉	广
㢜	广	廿	思
㢝	广	穌
㢞	广	翼
㢟	③	廴
㢠	冋	廴
㢡	將	廾
㢢	廾	敞
㢣	廾	敬
㢤	丿	十	弋	𠃌
㢥	同	弋
㢦	哥	弋
㢧	一	弓
㢨	干	弓
㢩	勺	弓
㢪	亏	弓
㢫	山	弓
㢬	厷	弓
㢭	弓	攴
㢮	㐌	弓
㢯	弓	民
㢰	弓	皮
㢱	厼	弓
㢲	一	八	弜
㢳	④	弓	𠂉
㢴	丶	丿	囗	弓
㢵	合	弓
㢶	弓	百
㢷	岁	弓
㢸	弓	𢎿
㢹	弓	辛
㢺	妾	弓
㢻	委	弓
㢼	㡀	弓
㢽	弓	耳
㢾	垔	弓
㢿	侯	弓
㣀	弓	真
㣁	弓	𤰇
㣂	弓	鬲
㣃	弓	育
㣄	弓	渠
㣅	弓	朁
㣆	弓	爾	王
㣇	丿	巾	彑
㣈	㣇
㣉	工	彡
㣊	彡	攵
㣋	丼	彡
㣌	占	彡
㣍	台	彡
㣎	小	彡	白
㣏	大	彡	早
㣐	彡	泉
㣑	庸	彡
㣒	彡	曾
㣓	彡	粲
㣔	丁	彳
㣕	大	彳
㣖	太	彳
㣗	彳	戶
㣘	句	彳
㣙	彳	由
㣚	同	彳
㣛	合	彳
㣜	刑	彳
㣝	彳	戎
㣞	兊	彳
㣟	吉	彳
㣠	丨	冬	彳
㣡	仲	彳
㣢	弟	彳
㣣	夾	彳
㣤	彳	戔
㣥	侍	彳
㣦	委	彳
㣧	彳	𦙌
㣨	姑	彳
㣩	彳	林
㣪	彳	爰
㣫	彳	重
㣬	咠	彳
㣭	㚇	彳
㣮	南	彳
㣯	屑	彳
㣰	彳	悉
㣱	彳	責
㣲	一	口	山	彳	攵
㣳	彳	無
㣴	彳	黃
㣵	彳	達
㣶	亶	彳
㣷	寧	彳
㣸	㽔	彳
㣹	彳	應
㣺	丶	小
㣻	乂	心
㣼	刃	忄
㣽	女	心
㣾	叉	忄
㣿	勺	忄
㤀	兦	心
㤁	天	心
㤂	及	心
㤃	忄	方
㤄	巿	忄
㤅	心	旡
㤆	反	忄
㤇	夭	忄
㤈	心	忄
㤉	忄	牙
㤊	忄	爻
㤋	分	忄
㤌	忄	甘
㤍	巧	心
㤎	加	心
㤏	冬	忄
㤐	占	心
㤑	右	忄
㤒	夲	忄
㤓	忄	本
㤔	付	忄
㤕	出	忄
㤖	宁	忄
㤗	㣺	𡗗
㤘	刍	忄
㤙	囙	心
㤚	忄	行
㤛	任	忄
㤜	忄	戍
㤝	充	忄
㤞	宅	忄
㤟	心	曲
㤠	列	心
㤡	列	忄
㤢	忄	有
㤣	并	心
㤤	乂	忄	日
㤥	亥	忄
㤦	吏	忄
㤧	后	忄
㤨	共	忄
㤩	各	心
㤪	一	怨
㤫	心	有
㤬	圭	忄
㤭	乔	忄
㤮	心	狂
㤯	冏	忄
㤰	作	心
㤱	忄	豆
㤲	夾	心
㤳	否	忄
㤴	忄	𦔮
㤵	孜	心
㤶	尨	忄
㤷	含	忄
㤸	忄	赤
㤹	忄	求
㤺	巟	忄
㤻	卵	心
㤼	劫	忄
㤽	寿	忄
㤾	忄	罙
㤿	奄	忄
㥀	忄	直
㥁	十	心	罒	𠃊
㥂	㝵	忄
㥃	忄	門
㥄	夌	忄
㥅	受	忄
㥆	忄	隶
㥇	忄	戔
㥈	帖	心
㥉	咅	忄
㥊	忄	朋
㥋	依	心
㥌	匊	忄
㥍	其	忄
㥎	心	𥝢
㥏	典	忄
㥐	命	心
㥑	⑧	心
㥒	忄	采
㥓	奇	忄
㥔	忄	育
㥕	心	炎
㥖	丹	忩
㥗	忄	旻
㥘	刼	忄
㥙	忄	忠
㥚	忄	臾
㥛	亟	忄
㥜	忄	胃
㥝	弭	忄
㥞	㒸	忄
㥟	彖	忄
㥠	忄	胥
㥡	忄	𣐉
㥢	忄	酋
㥣	奎	心
㥤	心	矜
㥥	忄	禺
㥦	匧	心
㥧	忄	頁
㥨	娃	心
㥩	忄	者
㥪	娄	忄
㥫	亯	忄
㥬	忄	旁
㥭	忄	泰
㥮	忄	芻
㥯	心	𤔌
㥰	叟	忄
㥱	匪	忄
㥲	心	真
㥳	原	忄
㥴	忄	虒
㥵	圂	忄
㥶	心	𡨄
㥷	㤲	广
㥸	思	民
㥹	心	粉
㥺	忄	盍
㥻	心	戊	禾
㥼	忄	焉
㥽	忄	責
㥾	匿	忄
㥿	心	敖
㦀	忄	逢
㦁	心	連
㦂	常	心
㦃	忄	産
㦄	心	麻
㦅	帶	忄
㦆	忄	虖
㦇	忄	鹿
㦈	忄	盖
㦉	壹	忄
㦊	忄	華
㦋	奢	忄
㦌	心	毳
㦍	㖾	忄
㦎	忄	畫
㦏	巽	忄
㦐	忄	貳
㦑	忄	敢
㦒	忄	詈
㦓	忄	然
㦔	心	猒
㦕	忄	隆
㦖	忄	悶
㦗	忄	禁
㦘	心	敫
㦙	忄	愚
㦚	心	辛
㦛	心	與
㦜	忄	蒦
㦝	心	貌
㦞	壽	心
㦟	心	貍
㦠	對	忄
㦡	忄	樂
㦢	忄	節
㦣	心	衛
㦤	壹	𬅟
㦥	忄	憲
㦦	䦧	忄
㦧	㬱	忄
㦨	忄	闌
㦩	忄	隱
㦪	忄	燮
㦫	忄	贊
㦬	忄	羅
㦭	忄	靈
㦮	二	戈
㦯	一	厶	戈
㦰	从	戈
㦱	一	土	戈
㦲	丿	𠃌	𢦏
㦳	土	𢦏
㦴	各	戈
㦵	戈	朱
㦶	戈	至
㦷	戈	甬
㦸	卓	戈
㦹	戈	昜
㦺	戈	辱
㦻	戈	習
㦼	戈	舂
㦽	有	𡿿
㦾	也	户
㦿	户	木
㧀	及	户
㧁	去	户
㧂	户	田
㧃	丩	扌
㧄	凵	扌
㧅	刀	扌
㧆	巾	扌
㧇	扌	𠔼
㧈	弓	扌
㧉	扌	气
㧊	巿	扌
㧋	扌	犬
㧌	扌	毛
㧍	扌	方
㧎	扌	牙
㧏	冈	扌
㧐	双	扌
㧑	为	扌
㧒	扌	穴
㧓	扌	瓜
㧔	戊	扌
㧕	卯	扌
㧖	戹	扌
㧗	扌	此
㧘	手	此
㧙	必	扌
㧚	扌	瓦
㧛	〢	丶	手	𠂉
㧜	匝	扌
㧝	加	手
㧞	叐	扌
㧟	扌	汇
㧠	厼	扌
㧡	亥	扌
㧢	因	扌
㧣	扌	朱
㧤	充	扌
㧥	先	扌
㧦	扌	旬
㧧	㐬	扌
㧨	后	扌
㧩	扌	𫥞
㧪	危	扌
㧫	扌	而
㧬	巩	手
㧭	手	邛
㧮	扌	臼
㧯	扌	老
㧰	乐	扌
㧱	合	手
㧲	宋	扌
㧳	手	扮
㧴	我	扌
㧵	否	扌
㧶	扌	身
㧷	吞	扌
㧸	亨	扌
㧹	㝵	扌
㧺	扌	沓
㧻	扌	豖
㧼	扌	表
㧽	固	扌
㧾	忽	扌
㧿	从	扌	龰
㨀	扌	秉
㨁	扌	直
㨂	扌	東
㨃	享	扌
㨄	周	扌
㨅	扌	芮
㨆	扌	林
㨇	手	波
㨈	扌	斉
㨉	扌	昬
㨊	左	扌	月
㨋	扌	者
㨌	冖	士	手	殳
㨍	封	手
㨎	扌	耎
㨏	扌	炭
㨐	保	扌
㨑	㚇	扌
㨒	奎	扌
㨓	扌	窂
㨔	咸	扌
㨕	扌	盈
㨖	扌	致
㨗	⺊	コ	一	扌	龰
㨘	扌	省
㨙	奚	扌
㨚	扌	荀
㨛	扌	閃
㨜	扌	虔
㨝	屑	扌
㨞	扌	素
㨟	扌	豈
㨠	冥	扌
㨡	圂	扌
㨢	扌	能
㨣	扌	翁
㨤	扌	龨
㨥	扌	納
㨦	扌	隻
㨧	扌	畚
㨨	扌	留
㨩	庭	扌
㨪	扌	晃
㨫	扌	监
㨬	扌	袁
㨭	扈	扌
㨮	兜	扌
㨯	扌	郭
㨰	扌	衮
㨱	䚻	扌
㨲	扌	𦯕
㨳	寄	扌
㨴	乾	扌
㨵	剪	扌
㨶	扌	鳥
㨷	堇	扌
㨸	密	扌
㨹	彗	扌
㨺	㒼	扌
㨻	手	斬
㨼	手	略
㨽	副	扌
㨾	扌	羕
㨿	扌	處
㩀	䖏	扌
㩁	寉	扌
㩂	扌	斛
㩃	寒	扌
㩄	崽	扌
㩅	扌	畱
㩆	就	扌
㩇	扌	畫
㩈	扌	窘
㩉	扌	翕
㩊	扌	𡬳
㩋	扌	肅
㩌	扌	費
㩍	扌	策
㩎	扌	猒
㩏	扌	黑
㩐	扌	等
㩑	䨿	扌
㩒	扌	禁
㩓	手	毀
㩔	扌	殿
㩕	扌	零
㩖	扌	畺
㩗	扌	𡻎
㩘	扌	義
㩙	塞	扌
㩚	扌	蒙
㩛	團	扌
㩜	扌	監
㩝	扌	豪
㩞	扌	榮
㩟	寨	扌
㩠	扌	麃
㩡	扌	磊
㩢	扌	蔑
㩣	扌	翬
㩤	扌	敷
㩥	扌	韯
㩦	扌	𮥼
㩧	扌	暴
㩨	慧	扌
㩩	扌	潁
㩪	䋶	扌
㩫	扌	質
㩬	戱	扌
㩭	學	扌
㩮	扌	擧
㩯	扌	繁
㩰	扌	𦾈
㩱	扌	爵
㩲	扌	雚
㩳	扌	雙
㩴	扌	瞿
㩵	扌	獻
㩶	扌	籋
㩷	扌	騫
㩸	扌	疉
㩹	扌	疊
㩺	支	比
㩻	危	支
㩼	多	支
㩽	支	束
㩾	垂	支
㩿	乞	攵
㪀	于	攵
㪁	今	攴
㪂	攴	气
㪃	可	攴
㪄	弗	攵
㪅	丙	攴
㪆	攴	氐
㪇	先	攵
㪈	圭	攴
㪉	合	攵
㪊	君	攴
㪋	攴	旱
㪌	攴	甬
㪍	孛	攵
㪎	夾	攴
㪏	卑	攴
㪐	戾	攴
㪑	奄	攴
㪒	兒	攴
㪓	乖	攴
㪔	攴	林
㪕	卓	攴
㪖	录	攴
㪗	咅	攴
㪘	㑒	攵
㪙	攵	果
㪚	攵	昔
㪛	攴	甚
㪜	攴	耑
㪝	攴	柬
㪞	冒	攴
㪟	亯	攵
㪠	兼	攴
㪡	害	攴
㪢	叟	攴
㪣	攵	高
㪤	攵	畢
㪥	攴	虘
㪦	寅	攵
㪧	攴	翕
㪨	善	攴
㪩	攴	肅
㪪	䨿	攴
㪫	攴	睿
㪬	攴	翟
㪭	攴	盧
㪮	攴	霝
㪯	丨	二	文
㪰	文	米
㪱	奐	文
㪲	斗	𠃍
㪳	㇣	斗
㪴	元	斗
㪵	半	斗
㪶	斗	百
㪷	斗	豆
㪸	其	斗
㪹	婁	斗
㪺	斗	𥇛
㪻	䜌	斗
㪼	可	斤
㪽	一	昕
㪾	各	斤
㪿	屮	斤
㫀	斤	昌
㫁	兀	斤	𠃊	𢆶
㫂	庶	斤
㫃	人	方
㫄	二	勹	方
㫅	亓	人	方
㫆	尒	方
㫇	於	𠃍
㫈	㇣	於
㫉	危	方
㫊	可	方	𠂉
㫋	冉	方	𠂉
㫌	方	正	𠂉
㫍	攸	方	𠂉
㫎	方	軍	𠂉
㫏	方	要	𠂉
㫐	匕	日
㫑	力	日
㫒	廾	日
㫓	乞	日
㫔	上	日
㫕	兀	日
㫖	上	日
㫗	子	日
㫘	不	日
㫙	夫	日
㫚	勿	日
㫛	兄	日
㫜	日	旦
㫝	日	氐
㫞	日	𠬢
㫟	口	日	𠘧
㫠	半	日
㫡	冬	日
㫢	去	日
㫣	日	电
㫤	日	𣱳
㫥	名	日
㫦	丨	亻	𣅈
㫧	日	米
㫨	安	日
㫩	卉	日
㫪	旧	𡗗
㫫	亚	日
㫬	日	旬
㫭	寺	日
㫮	日	此
㫯	兀	昌
㫰	日	良
㫱	日	赤
㫲	孛	日
㫳	日	辰
㫴	孝	日
㫵	日	非
㫶	帚	日
㫷	其	日
㫸	日	疌
㫹	所	日
㫺	日	𠈌
㫻	侖	日
㫼	制	日
㫽	录	日
㫾	尙	日
㫿	日	隹
㬀	享	日
㬁	日	洽
㬂	日	禺
㬃	日	炱
㬄	日	𪠇
㬅	方	日	罒
㬆	日	昬
㬇	奐	日
㬈	日	昷
㬉	日	耎
㬊	日	爰
㬋	侯	日
㬌	亰	日
㬍	尃	日
㬎	日	𢇁
㬏	日	鬲
㬐	日	晋
㬑	日	郭
㬒	日	莽
㬓	日	票
㬔	日	翏
㬕	日	祥
㬖	啓	日
㬗	日	然
㬘	日	肅
㬙	日	爲
㬚	攵	日	育
㬛	日	翕
㬜	日	臸
㬝	日	曾
㬞	山	日	曷
㬟	勿	曾
㬠	日	煞
㬡	日	零
㬢	日	義
㬣	對	日
㬤	㬎	日
㬥	大	米	𣅽
㬦	日	蒦
㬧	大	糸	𣅽
㬨	日	赫
㬩	慧	日
㬪	宐	晶
㬫	日	燕
㬬	日	瞿
㬭	日	爵
㬮	日	難
㬯	日	羸
㬰	人	日
㬱	兟	日
㬲	更	益
㬳	午	月
㬴	共	月
㬵	交	月
㬶	告	月
㬷	困	月
㬸	月	花
㬹	争	月
㬺	帣	月
㬻	月	荒
㬼	复	有
㬽	月	𠵛
㬾	月	殹
㬿	敦	月
㭀	月	筮
㭁	乃	木
㭂	小	木
㭃	幺	木
㭄	卂	木
㭅	三	木
㭆	乃	末
㭇	允	木
㭈	夬	木
㭉	木	艹
㭊	木	片
㭋	丰	木
㭌	木	牛
㭍	七	冫	木
㭎	冈	木
㭏	木	韦
㭐	大	末
㭑	木	未
㭒	㠯	木
㭓	弁	木
㭔	乎	木
㭕	去	木
㭖	代	木
㭗	木	皿
㭘	合	木
㭙	寺	木
㭚	④	木	𠂉
㭛	木	𠂢
㭜	戎	木
㭝	九	林
㭞	劣	木
㭟	共	朩
㭠	先	木
㭡	囟	木
㭢	刑	木
㭣	木	问
㭤	木	鸟
㭥	木	负
㭦	宅	木
㭧	木	舟
㭨	木	邪
㭩	寽	木
㭪	木	甫
㭫	坐	木
㭬	木	豕
㭭	别	木
㭮	木	𣧄
㭯	木	𦔮
㭰	朿	此
㭱	匣	木
㭲	木	谷
㭳	孝	木
㭴	坚	木
㭵	木	甸
㭶	木	芳
㭷	木	男
㭸	兔	木
㭹	弦	木
㭺	奄	木
㭻	尚	木
㭼	木	沓
㭽	底	木
㭾	屈	木
㭿	昂	木
㮀	函	木
㮁	木	肴
㮂	具	木
㮃	委	木
㮄	㫄	木
㮅	木	隹
㮆	木	𦍐
㮇	忝	木
㮈	奈	木
㮉	侠	木
㮊	予	木
㮋	木	郁
㮌	木	面
㮍	前	木
㮎	木	盃
㮏	木	柰
㮐	木	省
㮑	木	臿
㮒	垔	木
㮓	恆	木
㮔	木	重
㮕	木	耎
㮖	木	革
㮗	木	矜
㮘	敄	木
㮙	咢	木
㮚	木	𠧪
㮛	是	木
㮜	匨	木
㮝	卻	木
㮞	咨	木
㮟	木	柘
㮠	木	荣
㮡	木	炬
㮢	侯	木
㮣	既	朩
㮤	容	木
㮥	木	畚
㮦	木	索
㮧	木	烏
㮨	木	畟
㮩	息	木
㮪	木	𣑦
㮫	害	木
㮬	木	翁
㮭	圅	木
㮮	挈	木
㮯	圂	木
㮰	木	𣬉
㮱	木	𦭶
㮲	木	芻
㮳	朕	木
㮴	叟	木
㮵	旃	木
㮶	朔	木
㮷	尤	旨	木
㮸	木	送
㮹	木	致
㮺	本	𠱠
㮻	木	蚤
㮼	扇	木
㮽	木	般
㮾	朗	木
㮿	木	畢
㯀	旋	木
㯁	木	陪
㯂	帶	木
㯃	木	桼
㯄	巵	林
㯅	庳	木
㯆	木	産
㯇	木	𡌦
㯈	木	速
㯉	木	虖
㯊	木	焉
㯋	匕	木	頁
㯌	木	逐
㯍	將	木
㯎	木	言
㯏	木	殸
㯐	木	隋
㯑	張	木
㯒	木	覓
㯓	木	翕
㯔	木	毳
㯕	斯	木
㯖	木	𢛳
㯗	木	閑
㯘	木	款
㯙	攵	木	育
㯚	木	答
㯛	壺	木
㯜	木	萃
㯝	木	路
㯞	木	絹
㯟	彔	林
㯠	木	牽
㯡	包	桼
㯢	巽	木
㯣	木	棻
㯤	來
㯥	東
㯦	木	棊
㯧	木	超
㯨	木	粟
㯩	夷	桑
㯪	木	零
㯫	木	豦
㯬	建	林
㯭	木	虜
㯮	木	蜀
㯯	夅	木	貝
㯰	木	置
㯱	一	中	冖	木	缶
㯲	木	禁
㯳	敬	木
㯴	木	蓉
㯵	木	董
㯶	木	𡕰
㯷	僕	木
㯸	木	盡
㯹	木	𡬽
㯺	一	木	罒	臣	𠂉
㯻	一	中	冖	木	豕
㯼	木	蓋
㯽	木	賔
㯾	木	遭
㯿	巤	木
㰀	木	黎
㰁	木	磊
㰂	審	木
㰃	棉	系
㰄	木	賤
㰅	木	適
㰆	一	中	冖	棐
㰇	木	韯
㰈	林	連
㰉	木	臻
㰊	木	燅
㰋	木	頻
㰌	木	霍
㰍	木	龍
㰎	嶲	木
㰏	木	篙
㰐	木	隨
㰑	木	橤
㰒	學	木
㰓	一	木	臣	貝	𠂉
㰔	木	燮
㰕	木	羲
㰖	木	覧
㰗	木	蹙
㰘	彝	木
㰙	木	難
㰚	木	離
㰛	木	藥
㰜	木	顚
㰝	巳	欠
㰞	山	欠
㰟	欠	气
㰠	亢	欠
㰡	介	欠
㰢	开	欠
㰣	欠	此
㰤	可	欠
㰥	世	欠
㰦	去	欠
㰧	台	欠
㰨	只	欠
㰩	欠	虫
㰪	圭	欠
㰫	先	欠
㰬	旬	欠
㰭	夸	欠
㰮	欠	辰
㰯	欠	豆
㰰	夾	欠
㰱	欠	𢆍
㰲	或	欠
㰳	亞	欠
㰴	咅	欠
㰵	卒	欠
㰶	咎	欠
㰷	欠	死
㰸	㑒	欠
㰹	咸	欠
㰺	叚	欠
㰻	壴	欠
㰼	匧	欠
㰽	匽	欠
㰾	方	欠	白
㰿	奚	欠
㱀	欠	芻
㱁	欠	祟
㱂	康	欠
㱃	欠	酓
㱄	欠	黑
㱅	壹	欠
㱆	䖒	欠
㱇	嗇	欠
㱈	欠	禁
㱉	業	欠
㱊	憂	欠
㱋	欠	霍
㱌	欠	聶
㱍	䜌	欠
㱎	欠	眔	魚
㱏	一	正
㱐	㱐
㱑	夕	止
㱒	可	止
㱓	令	止
㱔	夕	此
㱕	帚	止
㱖	卒	止
㱗	止	臭
㱘	厭	止
㱙	丂	歹
㱚	月	歹
㱛	歹
㱜	歹	龰
㱝	力	死
㱞	歹	立
㱟	歹	皮
㱠	古	歹
㱡	先	歹
㱢	歹	良
㱣	妥	歹
㱤	析	歹
㱥	夌	歹
㱦	奇	歹
㱧	宛	歹
㱨	定	歹
㱩	卖	歹
㱪	昬	歹
㱫	柬	歹
㱬	歹	畏
㱭	歹	段
㱮	歹	贵
㱯	歹	豈
㱰	宰	歹
㱱	歹	鬼
㱲	歹	益
㱳	歹	莫
㱴	歹	責
㱵	歹	賁
㱶	彭	歹
㱷	歹	集
㱸	歹	辟
㱹	歷	歹
㱺	歹	盧
㱻	歹	羸
㱼	巳	殳
㱽	冘	殳
㱾	亥	殳
㱿	士	殳	𠔼
㲀	殳	辰
㲁	殳	空
㲂	尚	殳
㲃	殳	𠧢
㲄	冖	士	殳	王
㲅	害	殳
㲆	令	殸
㲇	冬	殸
㲈	召	殸
㲉	一	冖	卵	士	殳
㲊	殳	𥈠
㲋	比	𠮥
㲌	乃	毛
㲍	支	毛
㲎	毛
㲏	毛	片
㲐	今	毛
㲑	毛	水
㲒	句	毛
㲓	戍	毛
㲔	毛	辛
㲕	寽	毛
㲖	毛	肖
㲗	孚	毛
㲘	毛	貝
㲙	㐬	毛
㲚	毛	沙
㲛	毛	知
㲜	毛	炎
㲝	毛	隹
㲞	卒	毛
㲟	毛	英
㲠	攵	未	毛
㲡	柰	毛
㲢	扁	毛
㲣	叟	毛
㲤	毛	衰
㲥	唐	毛
㲦	人	毛	𠦝
㲧	毛	蚤
㲨	毛	茸
㲩	毛	𦐇
㲪	毛	登
㲫	毛	菐
㲬	毛	焦
㲭	毛	焱
㲮	毛	答
㲯	毛	監
㲰	寧	毛
㲱	巤	毛
㲲	毛	疊
㲳	失	氐
㲴	中	气
㲵	气	肖
㲶	气	鹵
㲷	單	气
㲸	乙	氵
㲹	几	氵
㲺	七	氵
㲻	亻	水
㲼	乂	氵
㲽	刃	氵
㲾	宀	水
㲿	广	氵
㳀	戈	氵
㳁	仄	氵
㳂	公	氵
㳃	卆	氵
㳄	欠	氵
㳅	不	氵
㳆	斗	氵
㳇	氵	父
㳈	氵	𣎳
㳉	月	氵
㳊	攵	氵
㳋	丘	氵
㳌	氵	甲
㳍	布	氵
㳎	弁	氵
㳏	史	氵
㳐	札	氵
㳑	氵	皿
㳒	厺	氵
㳓	右	氵
㳔	对	氵
㳕	兰	氵
㳖	氵	衣
㳗	叉	土	氵
㳘	充	氵
㳙	䏍	氵
㳚	戍	氵
㳛	氵	臾
㳜	休	氵
㳝	任	氵
㳞	仲	氵
㳟	共	氺
㳠	氵	达
㳡	氵	过
㳢	乔	氵
㳣	氵	老
㳤	⑦	氵
㳥	弄	氵
㳦	戒	氵
㳧	氵	𦔮
㳨	氵	𣧄
㳩	丹	江
㳪	否	氵
㳫	水	臼
㳬	氵	𭻾
㳭	呆	氵
㳮	尿	氵
㳯	氵	辛
㳰	弃	氵
㳱	氵	阳
㳲	氵	汰
㳳	克	氵
㳴	氵	𡊭
㳵	季	氵
㳶	乳	氵
㳷	曶	氵
㳸	氵	花
㳹	枉	氵
㳺	子	扌	氵	𠂉
㳻	昔	氵
㳼	或	水
㳽	弥	氵
㳾	氵	羌
㳿	氵	𣏋
㴀	䒦	氵
㴁	井	夭	氵
㴂	冉	江
㴃	戶	水	氵
㴄	囧	氵
㴅	儿	口	囗	水
㴆	帚	氵
㴇	水
㴈	岳	氵
㴉	亝	氵
㴊	氵	𪟄
㴋	氵	肃
㴌	姑	氵
㴍	承	氵
㴎	奈	氵
㴏	氵	王	穴
㴐	氵	眄
㴑	㡿	氵
㴒	弈	氵
㴓	思	氵
㴔	急	氵
㴕	䒩	氵
㴖	氵	革
㴗	氵	要
㴘	冒	氵
㴙	氵	臿
㴚	㒸	氵
㴛	氵	致
㴜	扁	氵
㴝	利	氽
㴞	旧	氵	爫
㴟	厚	氵
㴠	凾	氵
㴡	氵	香
㴢	㳞	氵
㴣	氵	洟
㴤	柱	氵
㴥	峭	氵
㴦	宮	氵
㴧	息	氵
㴨	朕	氵
㴩	氵	邕
㴪	氵	臬
㴫	氵	郡
㴬	射	氵
㴭	氵	窅
㴮	屑	氵
㴯	氵	脂
㴰	氵	能
㴱	氵	𥥍
㴲	氵	虒
㴳	土	尨	氵
㴴	氵	火	灭	𠃊
㴵	氵	𥁑
㴶	氵	隺
㴷	氵	耽
㴸	氵	閃
㴹	氵	迷
㴺	氵	浹
㴻	氵	𭔰
㴼	宿	氵
㴽	悉	氵
㴾	攵	浡
㴿	氵	頂
㵀	族	氵
㵁	㐬	氵	艹
㵂	庶	氵
㵃	氵	蛇
㵄	大	或	氵
㵅	氵	貪
㵆	晧	氵
㵇	氵	甜
㵈	㴌	氵
㵉	氵	淋
㵊	最	氵
㵋	氵	買
㵌	循	氵
㵍	悶	氵
㵎	氵	閒
㵏	氵	萃
㵐	厥	氵
㵑	氵	賀
㵒	氵	費
㵓	寔	氵
㵔	奢	氵
㵕	叅	氵
㵖	氵	絮
㵗	水	馮
㵘	沝
㵙	喜	氵
㵚	氵	𨥏
㵛	善	氵
㵜	氵	湳
㵝	氵	裔
㵞	愁	氵
㵟	微	氵
㵠	氵	窟
㵡	氵	雹
㵢	氵	雷
㵣	歇	氵
㵤	氵	翜
㵥	䀄	氵
㵦	氵	遀
㵧	氵	葛
㵨	水	辟
㵩	氵	葉
㵪	氵	羡
㵫	孴	氵
㵬	氵	𦝚
㵭	氵	煮
㵮	中	二	大	廿	氵
㵯	氵	鳳
㵰	氵	與
㵱	寸	漂
㵲	氵	舞
㵳	寥	氵
㵴	氵	臧
㵵	氵	聚
㵶	截	氵
㵷	氵	辛
㵸	氵	𠎤
㵹	汕	莫
㵺	氵	箄
㵻	氵	膄
㵼	冩	氵
㵽	氵	畾
㵾	氵	靚
㵿	氵	皛
㶀	氵	膠
㶁	氵	虢
㶂	氵	潢
㶃	氵	潕
㶄	氵	閻
㶅	學	氵
㶆	氵	諸
㶇	横	氵
㶈	氵	螢
㶉	奚	氵	鸟
㶊	氵	頣
㶋	㽔	氵
㶌	氵	聯
㶍	氵	鮮
㶎	氵	還
㶏	氵	隱
㶐	應	氵
㶑	歛	氵
㶒	氵	闖
㶓	氵	藏
㶔	奰	氵
㶕	氵	簡
㶖	儵	氵
㶗	䋣	泉
㶘	氵	簟
㶙	㶋	氵
㶚	氵	覇
㶛	旟	氵
㶜	𠝭	𣸹
㶝	㶐	氵
㶞	曩	氵
㶟	氵	纍
㶠	氵	驛
㶡	几	火
㶢	九	火
㶣	干	火
㶤	夕	火
㶥	干	火
㶦	予	火
㶧	内	火
㶨	不	灬
㶩	冘	火
㶪	不	火
㶫	火	𡗜
㶬	末	火
㶭	幼	火
㶮	丙	火
㶯	卯	火
㶰	火	甘
㶱	本	火
㶲	火	用
㶳	一	火	𦘒
㶴	多	火
㶵	任	灬
㶶	农	火
㶷	旬	火
㶸	劦	火
㶹	汞	火
㶺	吞	火
㶻	夆	灬
㶼	火	矣
㶽	呙	火
㶾	灭	覀
㶿	孛	火
㷀	卂	炏
㷁	火	甬
㷂	火	臤
㷃	火	長
㷄	果	火
㷅	取	火
㷆	火	阜
㷇	多	灰
㷈	奄	火
㷉	二	寸	尸	火
㷊	林	灬
㷋	火	炎
㷌	帚	火
㷍	侖	火
㷎	曷	火
㷏	火	𫀩
㷐	土	火	臼
㷑	垔	火
㷒	火	禺
㷓	怱	火
㷔	旧	火	爫
㷕	火	酋
㷖	召	炅
㷗	㇓	㠯	巳	火
㷘	枲	火
㷙	前	火
㷚	亭	火
㷛	保	灬
㷜	奕	火
㷝	火	突
㷞	厚	火
㷟	火	追
㷠	炎	舛
㷡	火	𥄷
㷢	差	火
㷣	火	牛	𦍌
㷤	一	冖	士	殳	火
㷥	丞	炎
㷦	灬	耿
㷧	原	火
㷨	峯	火
㷩	㇓	己	火	臣
㷪	火	隽
㷫	殸	火
㷬	火	莫
㷭	火	逢
㷮	曹	火
㷯	奉	𪢾
㷰	火	离
㷱	䏻	灬
㷲	動	火
㷳	火	雁
㷴	厤	火
㷵	火	黑
㷶	備	灬
㷷	巽	火
㷸	火	𬀽
㷹	䓬	火
㷺	火	𢽶
㷻	火	無
㷼	北	口	廿	火
㷽	善	火
㷾	火	豦
㷿	僉	火
㸀	㙜	火
㸁	業	火
㸂	火	遂
㸃	⑧	占	灬
㸄	火	齊
㸅	火	節
㸆	火	靠
㸇	火	賛
㸈	火	雔
㸉	火	辛
㸊	火	賴
㸋	炙	番
㸌	火	霍
㸍	戲	火
㸎	火	聶
㸏	火	靡
㸐	灬	難
㸑	冖	同	焚	𦥑
㸒	壬	爫
㸓	日	爫
㸔	目	𠂟
㸕	爪	隻
㸖	且	父
㸗	同	父
㸘	父	𦉬
㸙	父	者
㸚	爻
㸛	召	爿
㸜	爿	空
㸝	欠	片
㸞	片
㸟	旨	片
㸠	兆	片
㸡	朱	片
㸢	片	𤰇
㸣	業	片
㸤	片	辛
㸥	毚	片
㸦	㸦
㸧	牙	艮
㸨	丩	牛
㸩	干	牛
㸪	川	牛
㸫	斤	牛
㸬	巿	牛
㸭	巴	牛
㸮	分	牛
㸯	斗	牛
㸰	它	牛
㸱	㐌	牛
㸲	乍	牛
㸳	令	牛
㸴	牛	石
㸵	吉	牛
㸶	因	牛
㸷	㓞	牛
㸸	后	牛
㸹	寽	牛
㸺	沙	牛
㸻	牛	矣
㸼	夆	牛
㸽	牛	貝
㸾	忍	牛
㸿	売	牛
㹀	孛	牛
㹁	京	牛
㹂	牛	臤
㹃	牛	非
㹄	牛	畟
㹅	怱	牛
㹆	牛	軍
㹇	曷	牛
㹈	攵	未	牛
㹉	原	牛
㹊	牛	隺
㹋	修	牛
㹌	牛	産
㹍	啇	牛
㹎	牛	累
㹏	堇	牛
㹐	從	牛
㹑	牛	貳
㹒	牛	菐
㹓	堯	牛
㹔	牛	畺
㹕	牛	頑
㹖	牛	豢
㹗	壽	牛
㹘	牛	需
㹙	䁝	牛
㹚	營	牛
㹛	夒	牛
㹜	犬
㹝	氏	犭
㹞	斤	犭
㹟	夬	犭
㹠	屯	犭
㹡	犭	玄
㹢	加	犭
㹣	冬	犭
㹤	去	犭
㹥	主	犭
㹦	召	犭
㹧	央	犭
㹨	犭	由
㹩	圣	犭
㹪	册	犭
㹫	夷	犭
㹬	吏	犭
㹭	曳	犭
㹮	犭	百
㹯	休	犭
㹰	光	犭
㹱	犭	足
㹲	孝	犭
㹳	吾	犭
㹴	更	犭
㹵	巠	犭
㹶	廷	犭
㹷	希	犬
㹸	犭	皃
㹹	庚	犭
㹺	沓	犭
㹻	委	犭
㹼	匊	犭
㹽	戔	犭
㹾	咎	犭
㹿	卓	犭
㺀	忽	犭
㺁	犭	𡿺
㺂	咸	犭
㺃	犭	苟
㺄	俞	犭
㺅	犭	矦
㺆	大	犭	讠	贝
㺇	犬	犭	𦣞
㺈	犭	蚩
㺉	一	冖	士	殳	犬
㺊	恙	犭
㺋	犭	翁
㺌	兼	犭
㺍	宾	犭
㺎	庸	犭
㺏	婁	犭
㺐	巢	犭
㺑	參	犭
㺒	犭	翏
㺓	犭	責
㺔	爲	犭
㺕	犭	番
㺖	敢	犭
㺗	單	犭
㺘	焦	犭
㺙	宀	母	犭	贝
㺚	犭	達
㺛	犭	馵
㺜	犭	農
㺝	犭	監
㺞	犭	與
㺟	犭	翟
㺠	犭	窳
㺡	歷	犭
㺢	犭	霍
㺣	戲	犭
㺤	犭	韱
㺥	毚	犭
㺦	犭	聯
㺧	囂	犭
㺨	厶	王
㺩	丩	王
㺪	卜	王
㺫	刂	王
㺬	卂	王
㺭	子	王
㺮	亏	王
㺯	大	王
㺰	帀	王
㺱	仍	玉
㺲	丑	王
㺳	攴	王
㺴	犬	王
㺵	欠	王
㺶	斗	王
㺷	朮	王
㺸	玉	𠆩
㺹	弁	王
㺺	王	目
㺻	巿	王
㺼	王	疋
㺽	丕	王
㺾	冋	王
㺿	王	𦣞
㻀	乂	日	王
㻁	回	王
㻂	并	王
㻃	曲	玉
㻄	丿	王	𤴓
㻅	会	王
㻆	䏍	王
㻇	全	王
㻈	后	王
㻉	步	王
㻊	免	王
㻋	束	王
㻌	余	王
㻍	吴	王
㻎	大	玨
㻏	灵	王
㻐	夋	王
㻑	季	王
㻒	囷	王
㻓	取	王
㻔	垂	王
㻕	屈	王
㻖	王	隶
㻗	玉	非
㻘	审	王
㻙	王	育
㻚	朋	王
㻛	易	王
㻜	从	王	龰
㻝	剌	王
㻞	扁	王
㻟	左	月	王
㻠	王	突
㻡	枼	王
㻢	施	王
㻣	王	甚
㻤	王	苟
㻥	王	酋
㻦	王	禺
㻧	桀	王
㻨	㕚	玉	臣
㻩	兼	王
㻪	王	隽
㻫	王	畢
㻬	王	雩
㻭	率	王
㻮	王	祭
㻯	王	虖
㻰	彗	王
㻱	王	逢
㻲	婁	王
㻳	王	莉
㻴	曼	王
㻵	孱	王
㻶	王	筆
㻷	棘	王
㻸	朁	王
㻹	玉	石	豕
㻺	厤	玉
㻻	敦	王
㻼	王	覃
㻽	王	雋
㻾	玉	雍
㻿	王	蜀
㼀	王	達
㼁	王	義
㼂	②	丿	冖	玉	𦥑
㼃	巤	王
㼄	王	畿
㼅	廣	王
㼆	王	瑩
㼇	嶲	王
㼈	王	羅
㼉	冘	瓜
㼊	屯	瓜
㼋	古	瓜
㼌	瓜
㼍	瓜	耒
㼎	交	瓜
㼏	妥	瓜
㼐	扁	瓜
㼑	柬	瓜
㼒	昜	瓜
㼓	兼	瓜
㼔	昷	瓜
㼕	瓜	當
㼖	瓜	蠡
㼗	丁	瓦
㼘	山	瓦
㼙	巾	瓦
㼚	亢	瓦
㼛	开	瓦
㼜	央	瓦
㼝	夗	瓦
㼞	平	瓦
㼟	瓦	白
㼠	它	瓦
㼡	朱	瓦
㼢	瓦	𦣞
㼣	瓦	百
㼤	㓞	瓦
㼥	瓦	考
㼦	巩	瓦
㼧	瓦	甬
㼨	含	瓦
㼩	成	瓦
㼪	夾	瓦
㼫	果	瓦
㼬	幸	瓦
㼭	坫	瓦
㼮	妻	瓦
㼯	東	瓦
㼰	卑	瓦
㼱	㓁	北	瓦
㼲	瓦	耎
㼳	瓦	省
㼴	瓦	禺
㼵	是	瓦
㼶	俞	瓦
㼷	瓦	耑
㼸	容	瓦
㼹	瓦	荒
㼺	唐	瓦
㼻	從	瓦
㼼	瓦	票
㼽	爽	瓦
㼾	瓦	鹿
㼿	瓦	童
㽀	奠	瓦
㽁	厤	瓦
㽂	瓦	翕
㽃	瓦	番
㽄	斯	瓦
㽅	瓦	登
㽆	瓦	當
㽇	瓦	𦥯
㽈	瓦	疑
㽉	一	瓦	罒	臣	𠂉
㽊	燮	瓦
㽋	䜌	瓦
㽌	瓦	霤
㽍	瓦	甘
㽎	冘	甚
㽏	洽	甘
㽐	兼	甘
㽑	甘	覃
㽒	生	男
㽓	生	甡
㽔	业	生	𧰨
㽕	由	𢎘
㽖	力	田
㽗	人	田
㽘	亢	田
㽙	允	田
㽚	牛	田
㽛	句	田
㽜	夗	田
㽝	列	田
㽞	吅	田
㽟	寽	田
㽠	夾	田
㽡	卑	田
㽢	奄	田
㽣	或	田
㽤	匊	田
㽥	柔	田
㽦	田	𤇾
㽧	兹	田
㽨	差	田
㽩	參	田
㽪	曾	田
㽫	田	雍
㽬	畐
㽭	田	需
㽮	生	畾
㽯	巂	田
㽰	朋	疋
㽱	丩	疒
㽲	丂	疒
㽳	于	疒
㽴	丈	疒
㽵	土	疒
㽶	己	疒
㽷	水	疒
㽸	冘	疒
㽹	反	疒
㽺	及	疒
㽻	支	疒
㽼	引	疒
㽽	古	疒
㽾	出	疒
㽿	瓜	疒
㾀	去	疒
㾁	术	疒
㾂	台	疒
㾃	它	疒
㾄	由	疒
㾅	疒	𠂔
㾆	冉	疒
㾇	疒	目
㾈	付	疒
㾉	令	疒
㾊	朿	疒
㾋	休	疒
㾌	先	疒
㾍	疒	而
㾎	凹	疒
㾏	圭	疒
㾐	列	疒
㾑	合	疒
㾒	如	疒
㾓	疒	肙
㾔	吕	疒
㾕	疒	辛
㾖	疒	里
㾗	疒	良
㾘	更	疒
㾙	希	疒
㾚	些	疒
㾛	疒	𠬶
㾜	夾	疒
㾝	疒	車
㾞	疒	酉
㾟	步	疒
㾠	狂	疒
㾡	却	疒
㾢	來	疒
㾣	疒	金
㾤	疒	空
㾥	叔	疒
㾦	咅	疒
㾧	果	疒
㾨	奇	疒
㾩	乖	疒
㾪	疒	省
㾫	扁	疒
㾬	疒	皆
㾭	疒	秋
㾮	疒	皇
㾯	畏	疒
㾰	疒	胡
㾱	疒	発
㾲	敖	疒
㾳	姿	疒
㾴	査	疒
㾵	疒	計
㾶	疒	骨
㾷	疒	虒
㾸	疒	高
㾹	柴	疒
㾺	疒	馬
㾻	疒	除
㾼	疒	退
㾽	疒	追
㾾	兼	疒
㾿	疒	郎
㿀	班	疒
㿁	疒	皋
㿂	㞷	攵	疒
㿃	帶	疒
㿄	殹	疒
㿅	徙	疒
㿆	疒	禾	衣
㿇	疒	習
㿈	乡	疒	隹
㿉	疒	貴
㿊	朁	疒
㿋	喿	疒
㿌	僉	疒
㿍	疒	解
㿎	疒	賁
㿏	疒	羣
㿐	疒	趍
㿑	疒	翟
㿒	壽	疒
㿓	㾜	足
㿔	畾	疒
㿕	疒	閻
㿖	疒	盧
㿗	疒	頽
㿘	營	疒
㿙	奰	疒
㿚	疒	羅
㿛	疒	麗
㿜	疒	自	龠
㿝	厶	白
㿞	毛	白
㿟	白
㿠	光	白
㿡	兆	白
㿢	明	白
㿣	曷	白
㿤	春	白
㿥	白	隺
㿦	殸	白
㿧	壽	白
㿨	歷	白
㿩	白	黨
㿪	丸	皮
㿫	比	皮
㿬	巴	皮
㿭	斥	皮
㿮	央	皮
㿯	合	皮
㿰	交	皮
㿱	折	皮
㿲	奇	皮
㿳	甾	皮
㿴	皮	耷
㿵	皮	耎
㿶	旁	皮
㿷	差	皮
㿸	曼	皮
㿹	皮	達
㿺	暴	皮
㿻	干	皿
㿼	开	皿
㿽	兮	皿
㿾	宁	皿
㿿	疋	皿
䀀	氾	皿
䀁	有	皿
䀂	安	皿
䀃	皿	豕
䀄	宓	皿
䀅	皿	社
䀆	⺻	火	皿
䀇	古	皿	缶
䀈	既	皿
䀉	喬	皿
䀊	漻	皿
䀋	土	皿	鹵	𠂉
䀌	皕	皿	聿
䀍	皿	贛
䀎	丂	目
䀏	勹	目
䀐	彡	目
䀑	叉	目
䀒	千	目
䀓	丸	目
䀔	刃	目
䀕	引	目
䀖	天	目
䀗	夬	目
䀘	开	目
䀙	切	目
䀚	卬	目
䀛	勿	目
䀜	勿	目
䀝	比	目
䀞	斗	目
䀟	弗	目
䀠	目
䀡	占	目
䀢	目	矢
䀣	必	目
䀤	外	目
䀥	乐	目
䀦	古	目
䀧	共	目
䀨	目	舌
䀩	各	目
䀪	目	行
䀫	合	目
䀬	全	目
䀭	亥	目
䀮	巟	目
䀯	甫	目
䀰	目	谷
䀱	夆	目
䀲	每	目
䀳	束	目
䀴	巠	目
䀵	目	矣
䀶	目	良
䀷	劫	目
䀸	折	目
䀹	夾	目
䀺	攸	目
䀻	甹	目
䀼	目	辰
䀽	延	目
䀾	又	目	石
䀿	折	目
䁀	折	目
䁁	京	目
䁂	目	臤
䁃	目	表
䁄	幸	目
䁅	孟	目
䁆	奄	目
䁇	宓	目
䁈	目	𢼄
䁉	戈	戶	目
䁊	叉	目
䁋	枼	目
䁌	目	胃
䁍	咸	目
䁎	亭	目
䁏	目	要
䁐	目	英
䁑	昜	目
䁒	咠	目
䁓	㚇	目
䁔	爰	目
䁕	昬	目
䁖	娄	目
䁗	目	豈
䁘	䍃	目
䁙	晏	目
䁚	員	目
䁛	目	鬼
䁜	晃	目
䁝	目	𤇾
䁞	丆	目	𠈌
䁟	差	目
䁠	兼	目
䁡	目	閃
䁢	旋	目
䁣	專	目
䁤	啇	目
䁥	匿	目
䁦	目	虘
䁧	口	夫	廿	目
䁨	目	郭
䁩	目	魚
䁪	斬	目
䁫	目	黑
䁬	曾	目
䁭	猋	目
䁮	朁	目
䁯	目	翕
䁰	目	項
䁱	堯	目
䁲	目	買
䁳	目	莽
䁴	亶	目
䁵	目	睘
䁶	敫	目
䁷	目	𦥯
䁸	目	農
䁹	目	辟
䁺	目	睪
䁻	樂	目
䁼	墨	目
䁽	巤	目
䁾	目	蔑
䁿	目	默
䂀	目	羲
䂁	毚	目
䂂	目	瞿
䂃	爵	目
䂄	目	矍
䂅	目	蠻
䂆	勺	矛
䂇	丑	矛
䂈	矛	虫
䂉	侯	矛
䂊	矛	象
䂋	㐄	古	柔
䂌	矛	童
䂍	暴	矛
䂎	矛	贊
䂏	召	矢
䂐	出	矢
䂑	此	矢
䂒	矢	𠮷
䂓	矢	見
䂔	幸	矢
䂕	彖	矢
䂖	丶	石
䂗	匕	石
䂘	叉	石
䂙	石	阝
䂚	爻	石
䂛	予	石
䂜	丰	石
䂝	戈	石
䂞	木	石
䂟	加	石
䂠	矢	石
䂡	丘	石
䂢	冬	石
䂣	此	石
䂤	付	石
䂥	民	石
䂦	㐱	石
䂧	尔	石
䂨	斥	石
䂩	因	石
䂪	兆	石
䂫	夅	石
䂬	巩	石
䂭	交	石
䂮	㓞	石
䂯	庄	石
䂰	利	石
䂱	兑	石
䂲	劫	石
䂳	坐	石
䂴	石	言
䂵	石	贡
䂶	劫	石
䂷	乖	石
䂸	或	石
䂹	炙	石
䂺	果	石
䂻	石	長
䂼	念	石
䂽	卓	石
䂾	來	石
䂿	沓	石
䃀	妻	石
䃁	亞	石
䃂	昆	石
䃃	石	罔
䃄	京	石
䃅	单	石
䃆	其	石
䃇	帛	石
䃈	皆	石
䃉	昬	石
䃊	石	苴
䃋	俞	石
䃌	垔	石
䃍	㒸	石
䃎	奓	石
䃏	星	石
䃐	石	突
䃑	石	般
䃒	石	鬲
䃓	冓	石
䃔	宫	石
䃕	石	𤇾
䃖	烏	石
䃗	剥	石
䃘	堅	石
䃙	石	鹿
䃚	族	石
䃛	石	連
䃜	殹	石
䃝	教	石
䃞	孰	石
䃟	散	石
䃠	旋	石
䃡	朁	石
䃢	欽	石
䃣	爲	石
䃤	石	肅
䃥	石	童
䃦	敦	石
䃧	石	隆
䃨	强	石
䃩	石	農
䃪	亶	石
䃫	石	詹
䃬	嵬	石
䃭	感	石
䃮	石	達
䃯	楽	石
䃰	察	石
䃱	石	韯
䃲	盤	石
䃳	巤	石
䃴	石	諸
䃵	石	褭
䃶	石	褱
䃷	嬴	石
䃸	石	韱
䃹	石	闌
䃺	石	靡
䃻	石	霸
䃼	卜	示
䃽	支	礻
䃾	比	礻
䃿	夫	礻
䄀	戈	礻
䄁	世	礻
䄂	由	礻
䄃	央	礻
䄄	因	礻
䄅	示	龹
䄆	礻	舌
䄇	呈	礻
䄈	礻	豆
䄉	我	礻
䄊	志	礻
䄋	奄	礻
䄌	叕	礻
䄍	昔	礻
䄎	奇	礻
䄏	礻	芺
䄐	巳	祟
䄑	昏	礻
䄒	念	礻
䄓	皇	礻
䄔	礻	禹
䄕	畓	礻
䄖	兪	示
䄗	示	𣶒
䄘	旁	礻
䄙	冥	礻
䄚	曹	礻
䄛	婁	礻
䄜	礻	离
䄝	礻	舂
䄞	示	祭
䄟	毳	示
䄠	亶	礻
䄡	礻	詹
䄢	礻	齊
䄣	示	賣
䄤	礻	賴
䄥	礻	靈
䄦	了	禾
䄧	乃	禾
䄨	于	禾
䄩	弋	禾
䄪	勺	禾
䄫	己	禾
䄬	也	禾
䄭	千	禾
䄮	夫	禾
䄯	开	禾
䄰	牙	禾
䄱	方	禾
䄲	内	禾
䄳	止	禾
䄴	月	禾
䄵	㐄	禾
䄶	弗	禾
䄷	石	禾
䄸	白	禾
䄹	人	千	禾
䄺	夷	禾
䄻	兆	禾
䄼	㐁	禾
䄽	禾	西
䄾	戎	禾
䄿	曳	禾
䅀	列	禾
䅁	安	禾
䅂	各	禾
䅃	巩	禾
䅄	劦	禾
䅅	圭	禾
䅆	次	禾
䅇	禾	覀
䅈	禾	龹
䅉	亚	禾
䅊	㡯	禾
䅋	免	禾
䅌	禾	肙
䅍	廷	禾
䅎	禾	秀
䅏	尾	禾
䅐	禾	見
䅑	妥	禾
䅒	禾	芒
䅓	又	句	禾
䅔	甾	禾
䅕	居	禾
䅖	奄	禾
䅗	委	禾
䅘	來	禾
䅙	昆	禾
䅚	卷	禾
䅛	昌	禾
䅜	垂	禾
䅝	禾	空
䅞	㝵	禾
䅟	参	禾
䅠	是	禾
䅡	禾	頁
䅢	禾	胄
䅣	皇	禾
䅤	禾	臿
䅥	曷	禾
䅦	禾	苗
䅧	禾	音
䅨	禾	香
䅩	只	支	禾
䅪	禾	贵
䅫	亰	禾
䅬	益	禾
䅭	旁	禾
䅮	倉	禾
䅯	唐	禾
䅰	恩	禾
䅱	禾	豈
䅲	禾	耆
䅳	禾	芻
䅴	禾	索
䅵	禾	羔
䅶	禾	辱
䅷	禾	荼
䅸	禾	莘
䅹	婁	禾
䅺	票	禾
䅻	离	禾
䅼	曼	禾
䅽	殸	禾
䅾	朁	禾
䅿	禾	華
䆀	禾	黑
䆁	睪	禾
䆂	廉	禾
䆃	禾	道
䆄	亶	禾
䆅	禾	資
䆆	喿	禾
䆇	禾	鳯
䆈	禾	遲
䆉	禾	罷
䆊	冀	禾
䆋	⑮	禾
䆌	禾	諬
䆍	禾	龍
䆎	禾	韱
䆏	禾	糞
䆐	秦
䆑	丁	穴
䆒	丸	穴
䆓	允	穴
䆔	中	穴
䆕	夬	穴
䆖	厷	穴
䆗	叫	穴
䆘	甲	穴
䆙	正	穴
䆚	同	穴
䆛	吒	穴
䆜	有	穴
䆝	穴	血
䆞	㫐	穴
䆟	合	穴
䆠	穴	臣
䆡	穴	良
䆢	抉	穴
䆣	穴	辰
䆤	穴	身
䆥	穴	豕
䆦	炎	穴
䆧	委	穴
䆨	昊	穴
䆩	大	目	穴
䆪	光	空
䆫	怱	穴
䆬	員	穴
䆭	穴	軒
䆮	浸	穴
䆯	女	窡
䆰	區	穴
䆱	淡	穴
䆲	康	穴
䆳	穴	逐
䆴	亀	穴
䆵	曾	穴
䆶	焦	穴
䆷	矞	穴
䆸	登	穴
䆹	穴	童
䆺	番	穴
䆻	敢	穴
䆼	穴	過
䆽	穴	豦
䆾	監	穴
䆿	爿	穴	臬
䇀	穴	𩊐
䇁	穴	鮮
䇂	丨	立
䇃	巳	立
䇄	乞	立
䇅	戈	立
䇆	斗	立
䇇	民	立
䇈	圣	立
䇉	石	立
䇊	広	立
䇋	多	立
䇌	立	肖
䇍	立	足
䇎	昔	立
䇏	享	立
䇐	立	隶
䇑	卑	立
䇒	既	立
䇓	立	須
䇔	凡	吂	月	立
䇕	立	需
䇖	丿	勹	竹
䇗	公	竹
䇘	互	竹
䇙	引	竹
䇚	仆	竹
䇛	止	竹
䇜	欠	竹
䇝	戈	竹
䇞	甘	竹
䇟	力	夕	竹
䇠	主	竹
䇡	宁	竹
䇢	古	竹
䇣	尒	竹
䇤	丙	竹
䇥	正	竹
䇦	央	竹
䇧	㐁	竹
䇨	夅	竹
䇩	曳	竹
䇪	竹	至
䇫	竹	𦣞
䇬	朱	竹
䇭	竹	老
䇮	任	竹
䇯	竹	耳
䇰	丞	竹
䇱	囗	夂	竹
䇲	夹	竹
䇳	㦮	竹
䇴	竹	西
䇵	沂	竹
䇶	竹	角
䇷	别	竹
䇸	呈	竹
䇹	君	竹
䇺	竹	豆
䇻	尾	竹
䇼	竹	邑
䇽	折	竹
䇾	竹	言
䇿	束	竹
䈀	删	竹
䈁	侖	竹
䈂	并	竹
䈃	沼	竹
䈄	函	竹
䈅	或	竹
䈆	戾	竹
䈇	卓	竹
䈈	竹	肥
䈉	妾	竹
䈊	夌	竹
䈋	沓	竹
䈌	沮	竹
䈍	盲	竹
䈎	枼	竹
䈏	畐	竹
䈐	恢	竹
䈑	咼	竹
䈒	南	竹
䈓	曷	竹
䈔	叚	竹
䈕	是	竹
䈖	科	竹
䈗	俊	竹
䈘	兹	竹
䈙	竹	紂
䈚	怠	竹
䈛	㕟	竹
䈜	侵	竹
䈝	竹	胥
䈞	亯	竹
䈟	則	竹
䈠	爰	竹
䈡	怱	竹
䈢	枲	竹
䈣	政	竹
䈤	柑	竹
䈥	竹	觔
䈦	㚇	竹
䈧	為	竹
䈨	竹	限
䈩	剑	竹
䈪	竹	鬲
䈫	竹	納
䈬	浦	竹
䈭	竹	鬼
䈮	竘	竹
䈯	真	竹
䈰	捎	竹
䈱	竹	舀
䈲	竹	般
䈳	竹	𦐇
䈴	兼	竹
䈵	竹	翁
䈶	容	竹
䈷	格	竹
䈸	斛	竹
䈹	宿	竹
䈺	竹	終
䈻	竹	脯
䈼	密	竹
䈽	堇	竹
䈾	梢	竹
䈿	冥	竹
䉀	庶	竹
䉁	竹	聆
䉂	竹	累
䉃	將	竹
䉄	竹	陵
䉅	執	竹
䉆	竹	鳥
䉇	竹	𠝻
䉈	散	竹
䉉	竹	觚
䉊	竹	軬
䉋	媚	竹
䉌	竹	隊
䉍	悶	竹
䉎	棠	竹
䉏	竹	解
䉐	竹	軲
䉑	無	竹
䉒	番	竹
䉓	棵	竹
䉔	殘	竹
䉕	曾	竹
䉖	竹	軨
䉗	揖	竹
䉘	棕	竹
䉙	竹	雲
䉚	竹	罒	𤬦
䉛	奥	竹
䉜	竹	雉
䉝	竹	義
䉞	感	竹
䉟	㨦	竹
䉠	微	竹
䉡	亶	竹
䉢	嗇	竹
䉣	竹	舄
䉤	数	竹
䉥	摠	竹
䉦	竹	遷
䉧	劉	竹
䉨	毅	竹
䉩	樞	竹
䉪	畾	竹
䉫	竹	黎
䉬	廢	竹
䉭	巤	竹
䉮	竹	閵
䉯	竹	賢
䉰	竹	骹
䉱	䙔	竹
䉲	彌	竹
䉳	竹	鮮
䉴	竹	襄
䉵	食	𮅕
䉶	竹	雙
䉷	嚴	竹
䉸	竹	辯
䉹	竹	靈
䉺	工	米
䉻	氏	米
䉼	斤	米
䉽	半	米
䉾	北	米
䉿	乎	米
䊀	古	米
䊁	先	米
䊂	朿	米
䊃	米	𫥞
䊄	巩	米
䊅	名	米
䊆	米	臼
䊇	甫	米
䊈	每	米
䊉	宋	米
䊊	尾	米
䊋	壯	米
䊌	庇	米
䊍	米	𥝢
䊎	卷	米
䊏	炎	米
䊐	昆	米
䊑	尚	米
䊒	米	隹
䊓	是	米
䊔	米	英
䊕	建	米
䊖	南	米
䊗	皇	米
䊘	米	胄
䊙	研	米
䊚	米	追
䊛	殺	米
䊜	專	米
䊝	悉	米
䊞	啇	米
䊟	㒼	米
䊠	既	米
䊡	曼	米
䊢	將	米
䊣	米	黃
䊤	米	覃
䊥	米	肅
䊦	壹	米
䊧	米	費
䊨	几	吂	月	米
䊩	番	米
䊪	米	萬
䊫	米	罪
䊬	稞	米
䊭	壽	米
䊮	米	翟
䊯	廣	米
䊰	米	諸
䊱	米	韱
䊲	産	粟
䊳	米	靡
䊴	簽	米
䊵	九	糹
䊶	也	糹
䊷	才	糹
䊸	亏	糹
䊹	千	糹
䊺	互	糹
䊻	欠	糹
䊼	止	糹
䊽	夬	糹
䊾	木	糹
䊿	夫	糹
䋀	户	糸
䋁	亢	糹
䋂	爻	糹
䋃	毛	糹
䋄	冈	糹
䋅	牛	糸
䋆	戶	糸
䋇	尺	糸
䋈	奴	糸
䋉	穴	糹
䋊	正	糹
䋋	民	糹
䋌	巨	糹
䋍	可	糹
䋎	旦	糹
䋏	乍	糹
䋐	戉	糹
䋑	丙	糹
䋒	矛	糹
䋓	刍	糹
䋔	丕	糹
䋕	任	糸
䋖	糹	聿
䋗	糹	臣
䋘	糹	耒
䋙	糹	耳
䋚	糹	羽
䋛	米	糹
䋜	又	戶	糸
䋝	女	糸	𭕄
䋞	糹	网
䋟	忌	糹
䋠	甫	糹
䋡	余	糹
䋢	折	糸
䋣	每	糸
䋤	勺	素
䋥	糹	里
䋦	每	糹
䋧	居	糹
䋨	咅	糹
䋩	兒	糹
䋪	糹	阿
䋫	争	糹
䋬	忝	糹
䋭	糹	育
䋮	糹	金
䋯	戈	戶	糸
䋰	大	目	糸
䋱	來	糹
䋲	糹	黾
䋳	糹	背
䋴	柔	糹
䋵	曷	糹
䋶	糹	頁
䋷	敄	糸
䋸	盾	糹
䋹	畐	糹
䋺	秋	糹
䋻	南	糹
䋼	盈	糹
䋽	封	糹
䋾	奓	糹
䋿	畏	糹
䌀	科	糹
䌁	女	糹	襾
䌂	屋	糹
䌃	削	糹
䌄	㪅	糹
䌅	唐	糹
䌆	糹	鬼
䌇	糹	索
䌈	糹	𦐇
䌉	糹	罡
䌊	䍃	糹
䌋	糸	荅
䌌	糹	習
䌍	堇	糹
䌎	略	糸
䌏	密	糹
䌐	糹	覓
䌑	堅	糹
䌒	糹	鹿
䌓	糸	𭮬
䌔	區	糹
䌕	糹	麻
䌖	糹	集
䌗	無	糹
䌘	敝	糸
䌙	糹	黃
䌚	粟	糹
䌛	䚻	系
䌜	業	糹
䌝	禁	糹
䌞	僉	糹
䌟	糹	辟
䌠	㰹	糸
䌡	糹	豊
䌢	糹	零
䌣	管	糹
䌤	爾	糹
䌥	㥯	糹
䌦	糹	翟
䌧	壽	糹
䌨	糹	蔡
䌩	糹	蔑
䌪	糹	閻
䌫	糹	覧
䌬	糹	龍
䌭	糹	蕉
䌮	糹	霜
䌯	糹	雚
䌰	糹	聶
䌱	䇔	糹
䌲	糹	薰
䌳	璽	糹
䌴	糹	羸
䌵	屬	糹
䌶	才	纟
䌷	由	纟
䌸	专	纟
䌹	冋	纟
䌺	纟	耳
䌻	纟	羽
䌼	兑	纟
䌽	纟	采
䌾	南	纟
䌿	畐	纟
䍀	监	纟
䍁	纟	遂
䍂	于	缶
䍃	爫	缶
䍄	占	缶
䍅	令	缶
䍆	宁	缶
䍇	乏	缶
䍈	平	缶
䍉	只	缶
䍊	交	缶
䍋	垂	缶
䍌	咅	缶
䍍	一	冖	士	殳	缶
䍎	缶	薦
䍏	䍏
䍐	干	罒
䍑	干	网
䍒	木	罒
䍓	牙	罒
䍔	厷	罒
䍕	氐	罒
䍖	包	罒
䍗	玄	罒
䍘	米	罒
䍙	每	罒
䍚	罒	良
䍛	固	罒
䍜	罒	隹
䍝	沓	罒
䍞	或	网
䍟	㚇	罒
䍠	离	罒
䍡	罒	鹿
䍢	無	罒
䍣	罒	雷
䍤	罒	齊
䍥	歷	罒
䍦	罒	離
䍧	牛	羊
䍨	巿	羊
䍩	攵	羊
䍪	未	羊
䍫	它	羊
䍬	平	羊
䍭	母	羊
䍮	兆	羊
䍯	危	羊
䍰	因	羊
䍱	余	羊
䍲	兒	羊
䍳	叕	羊
䍴	委	羊
䍵	争	羊
䍶	東	羊
䍷	羊	韋
䍸	尃	羊
䍹	羊	臭
䍺	患	羊
䍻	巽	羊
䍼	朁	羊
䍽	歷	羊
䍾	开	羽
䍿	王	羽
䎀	戉	羽
䎁	古	羽
䎂	包	羽
䎃	冉	羽
䎄	召	羽
䎅	白	羽
䎆	令	羽
䎇	羽	舟
䎈	曳	羽
䎉	戍	羽
䎊	各	羽
䎋	告	羽
䎌	羽	足
䎍	甫	羽
䎎	羽	𦔮
䎏	含	羽
䎐	羽	𠦝
䎑	录	羽
䎒	戔	羽
䎓	沓	羽
䎔	尃	羽
䎕	羽	𤇾
䎖	曾	羽
䎗	喬	羽
䎘	羽	肅
䎙	羽	賓
䎚	慧	羽
䎛	口	老
䎜	老
䎝	羽	老
䎞	者	𠃍
䎟	女	而
䎠	丸	而
䎡	火	而
䎢	乞	耒
䎣	以	耒
䎤	局	耒
䎥	耒	谷
䎦	炎	耒
䎧	咅	耒
䎨	奄	耒
䎩	甾	耒
䎪	㝵	耒
䎫	㚇	耒
䎬	罢	耒
䎭	耒	造
䎮	啇	耒
䎯	口	夫	廿	耒
䎰	斮	耒
䎱	罷	耒
䎲	乙	耳
䎳	月	耳
䎴	井	耳
䎵	必	耳
䎶	申	耳
䎷	朱	耳
䎸	吾	耳
䎹	耳	釆
䎺	制	耳
䎻	周	耳
䎼	录	耳
䎽	昏	耳
䎾	侖	耳
䎿	秋	耳
䏀	剌	耳
䏁	宰	耳
䏂	叟	耳
䏃	冥	耳
䏄	窒	耳
䏅	祭	耳
䏆	曹	耳
䏇	票	耳
䏈	絲	耳
䏉	㬎	耳
䏊	耳	龍
䏋	八	巳	心	肀
䏌	八	月
䏍	⺼	厶
䏎	凡	月
䏏	于	月
䏐	夬	月
䏑	冫	肉	𠂊
䏒	月	片
䏓	⺼	元
䏔	丑	月
䏕	壬	月
䏖	引	月
䏗	月	气
䏘	匹	月
䏙	冘	月
䏚	少	月
䏛	勻	月
䏜	及	月
䏝	专	月
䏞	月	末
䏟	必	月
䏠	月	立
䏡	月	示
䏢	⺼	皮
䏣	⺼	且
䏤	⺼	司
䏥	冉	月
䏦	月	舌
䏧	多	月
䏨	月	𠂤
䏩	⺼	合
䏪	月	耳
䏫	⺼	休
䏬	⺼	牟
䏭	月	朱
䏮	丷	八	力	月
䏯	⺼	志
䏰	忍	月
䏱	局	月
䏲	弟	月
䏳	折	月
䏴	月	肖
䏵	尨	月
䏶	坒	月
䏷	⺼	旱
䏸	⺼	吾
䏹	⺼	見
䏺	⺼	夆
䏻	䏍	去
䏼	戔	月
䏽	咅	月
䏾	奉	月
䏿	月	𢼄
䐀	⺼	奇
䐁	月	豖
䐂	录	月
䐃	囷	月
䐄	月	臽
䐅	月	𡱁
䐆	月	采
䐇	曶	月
䐈	月	直
䐉	月	甾
䐊	昆	月
䐋	忩	月
䐌	⺼	典
䐍	⺼	壴
䐎	是	月
䐏	春	月
䐐	月	秋
䐑	月	枼
䐒	奓	月
䐓	月	頁
䐔	扁	月
䐕	咠	月
䐖	⺼	屎
䐗	月	者
䐘	月	爰
䐙	月	革
䐚	即	月
䐛	月	耷
䐜	月	真
䐝	月	𧴪
䐞	弱	月
䐟	冓	月
䐠	月	荒
䐡	③	丫	亠	刀	肉
䐢	月	芻
䐣	員	月
䐤	差	月
䐥	月	翁
䐦	⺼	盍
䐧	月	高
䐨	一	冖	士	月	殳
䐩	月	豈
䐪	月	隽
䐫	從	月
䐬	曹	月
䐭	帶	月
䐮	月	産
䐯	月	累
䐰	⺼	脩
䐱	啇	月
䐲	月	習
䐳	月	魚
䐴	既	月
䐵	月	黄
䐶	朁	月
䐷	單	月
䐸	⺼	畫
䐹	月	肅
䐺	月	覃
䐻	月	辜
䐼	月	絜
䐽	㒼	月
䐾	月	睪
䐿	奥	月
䑀	月	辟
䑁	月	𦥯
䑂	⺼	與
䑃	⺼	蒙
䑄	月	鼻
䑅	⺼	夢
䑆	⺼	養
䑇	月	質
䑈	月	樂
䑉	⺼	嬴
䑊	月	遺
䑋	月	襄
䑌	月	闌
䑍	嬰	月
䑎	月	韱
䑏	月	雚
䑐	尓	臣
䑑	臣	菐
䑒	刄	至
䑓	⑤	冖	至
䑔	巿	臼
䑕	臼	𠂡
䑖	疌	臼
䑗	昜	臼
䑘	差	臼
䑙	冄	舌
䑚	月	舌
䑛	氐	舌
䑜	枼	舌
䑝	冖	吅	舛
䑞	匚	炎	舛
䑟	皇	舜
䑠	了	舟
䑡	叉	舟
䑢	兀	舟
䑣	彡	舟
䑤	今	舟
䑥	及	舟
䑦	句	舟
䑧	付	舟
䑨	㐌	舟
䑩	古	舟
䑪	合	舟
䑫	并	舟
䑬	兆	舟
䑭	江	舟
䑮	朶	舟
䑯	弟	舟
䑰	步	舟
䑱	宛	舟
䑲	卓	舟
䑳	侖	舟
䑴	其	舟
䑵	冐	舟
䑶	舟	青
䑷	肩	舟
䑸	宗	舟
䑹	叜	舟
䑺	舟	風
䑻	斿	舟
䑼	舟	芻
䑽	舟	𦐇
䑾	舟	隻
䑿	宿	舟
䒀	符	舟
䒁	習	舟
䒂	將	舟
䒃	舟	造
䒄	冨	舟
䒅	眷	舟
䒆	攵	育	舟
䒇	富	舟
䒈	舟	賁
䒉	舞	舟
䒊	兮	色
䒋	央	色
䒌	冥	色
䒍	旁	色
䒎	色	莽
䒏	曾	色
䒐	瞢	色
䒑	一	丷
䒒	刁	艹
䒓	丂	艹
䒔	八	艹
䒕	小	艹
䒖	卂	艹
䒗	乞	艹
䒘	夂	艹
䒙	上	艹
䒚	少	艹
䒛	幻	艹
䒜	牛	艹
䒝	爻	艹
䒞	冘	艹
䒟	丹	艹
䒠	丰	艹
䒡	引	艹
䒢	卬	艹
䒣	冄	艹
䒤	日	艹
䒥	帀	艹
䒦	乏	艹
䒧	去	艹
䒨	矢	艹
䒩	禾	艹
䒪	弁	艹
䒫	代	艹
䒬	示	艹
䒭	ユ	寸	艹
䒮	艹	𠕵
䒯	丸	𫇦
䒰	匡	艹
䒱	丞	艹
䒲	奼	艹
䒳	朶	艹
䒴	有	艹
䒵	好	艹
䒶	曳	艹
䒷	舌	艹
䒸	艹	血
䒹	耒	艹
䒺	糸	艹
䒻	艹	𡵆
䒼	曲	艹
䒽	网	艹
䒾	艹	衣
䒿	肎	艹
䓀	吉	艹
䓁	寺	艹
䓂	艹	言
䓃	艹	邑
䓄	㹞	艹
䓅	沂	艹
䓆	折	艹
䓇	艹	赤
䓈	役	艹
䓉	艹	邪
䓊	吾	艹
䓋	汦	艹
䓌	志	艹
䓍	旱	艹
䓎	灼	艹
䓏	否	艹
䓐	艹	𡗥
䓑	汧	艹
䓒	甸	艹
䓓	寿	艹
䓔	孝	艹
䓕	艹	远
䓖	穷	艹
䓗	忩	艹
䓘	咎	艹
䓙	乖	艹
䓚	徂	艹
䓛	屈	艹
䓜	泜	艹
䓝	孟	艹
䓞	戾	艹
䓟	周	艹
䓠	沓	艹
䓡	知	艹
䓢	固	艹
䓣	兩	艹
䓤	忽	艹
䓥	入	草
䓦	典	艹
䓧	亟	艹
䓨	缶	𫇦
䓩	枝	艹
䓪	易	艹
䓫	奇	艹
䓬	卓	艹
䓭	刹	艹
䓮	敄	艹
䓯	毒	艹
䓰	垔	艹
䓱	柴	艹
䓲	侻	艹
䓳	很	艹
䓴	耎	艹
䓵	品	艹
䓶	剌	艹
䓷	洐	艹
䓸	姧	艹
䓹	艹	食
䓺	美	艹
䓻	㓂	艹
䓼	娏	艹
䓽	艹	記
䓾	娑	艹
䓿	圅	艹
䔀	倭	艹
䔁	栗	艹
䔂	宰	艹
䔃	祖	艹
䔄	䍃	艹
䔅	哥	艹
䔆	狸	艹
䔇	艹	豈
䔈	艹	貢
䔉	秝	艹
䔊	㻂	艹
䔋	紗	艹
䔌	皋	艹
䔍	艹	馬
䔎	艹	速
䔏	艹	造
䔐	淺	艹
䔑	斜	艹
䔒	艹	陪
䔓	艹	許
䔔	竟	艹
䔕	脯	艹
䔖	艹	陵
䔗	祥	艹
䔘	且	缶	艹
䔙	艹	釣
䔚	脣	艹
䔛	艹	頃
䔜	聃	艹
䔝	紫	艹
䔞	率	艹
䔟	移	艹
䔠	梢	艹
䔡	艹	魚
䔢	亏	艹	𠈌
䔣	犁	艹
䔤	白	百	艹
䔥	粛	艹
䔦	梅	艹
䔧	梨	艹
䔨	乡	艹	隹
䔩	敕	艹
䔪	爽	艹
䔫	朿	艹	𤴔
䔬	異	艹
䔭	甯	艹
䔮	斯	艹
䔯	艹	酤
䔰	富	艹
䔱	揖	艹
䔲	登	艹
䔳	然	艹
䔴	艹	𠭥
䔵	艹	閑
䔶	提	艹
䔷	琴	艹
䔸	猋	艹
䔹	艹	隊
䔺	艹	隋
䔻	敦	艹
䔼	歰	艹
䔽	渴	艹
䔾	揭	艹
䔿	尊	艹
䕀	款	艹
䕁	棐	艹
䕂	台	艹	辶	𧘇
䕃	艹	隂
䕄	䒱	皿
䕅	嫂	艹
䕆	榆	艹
䕇	廆	艹
䕈	牃	艹
䕉	睪	艹
䕊	亶	艹
䕋	塘	艹
䕌	稚	艹
䕍	艹	裔
䕎	日	畐	艹
䕏	義	艹
䕐	福	艹
䕑	綏	艹
䕒	嘉	艹
䕓	察	艹
䕔	艹	銜
䕕	漫	艹
䕖	艹	遜
䕗	艹	鼻
䕘	艹	領
䕙	截	艹
䕚	匱	艹
䕛	䛟	艹
䕜	翠	艹
䕝	稱	艹
䕞	艹	閬
䕟	興	艹
䕠	廢	艹
䕡	艹	閭
䕢	磋	艹
䕣	艹	褐
䕤	艹	鄲
䕥	艹	𤕨
䕦	嬴	艹
䕧	艹	骹
䕨	縢	艹
䕩	橑	艹
䕪	澤	艹
䕫	㔾	八	夂	止	白	艹
䕬	彊	艹
䕭	燅	艹
䕮	匊	幸	艹
䕯	瓢	艹
䕰	燔	艹
䕱	艹	頭
䕲	廩	艹
䕳	彌	艹
䕴	穛	艹
䕵	艹	鴶
䕶	艹	謢
䕷	縻	艹
䕸	艹	黠
䕹	艹	雜
䕺	叢	艹
䕻	艹	麗
䕼	艹	難
䕽	艹	躅
䕾	嚴	艹
䕿	艹	𪄿
䖀	囂	艹
䖁	意	萬
䖂	攣	艹
䖃	若
䖄	㸐	艹
䖅	艹	靈
䖆	艹	釀
䖇	艹	鬱
䖈	匕	虍
䖉	于	虍
䖊	㐅	虎
䖋	人	虎
䖌	刂	虎
䖍	攵	虍
䖎	虎	阝
䖏	匆	虍
䖐	斤	虎
䖑	日	虎
䖒	虍	豆
䖓	出	虎
䖔	去	虎
䖕	且	虎
䖖	甲	虎
䖗	咸	虍
䖘	兔	虎
䖙	卧	虒
䖚	烏	虎
䖛	索	虎
䖜	日	虤
䖝	丿	虫
䖞	寸	虫
䖟	亡	虫
䖠	凡	虫
䖡	丑	虫
䖢	少	虫
䖣	爪	虫
䖤	夗	虫
䖥	矛	虫
䖦	出	虫
䖧	旦	虫
䖨	石	虫
䖩	必	虫
䖪	此	虫
䖫	八	干	虫
䖬	甲	虫
䖭	虫	龹
䖮	向	虫
䖯	圭	虫
䖰	虫	𠂢
䖱	匡	虫
䖲	旬	虫
䖳	宅	虫
䖴	兆	虫
䖵	虫
䖶	虫	豕
䖷	希	虫
䖸	我	虫
䖹	⺸	虫
䖺	丨	亻	𧈸
䖻	㐬	虫
䖼	却	虫
䖽	利	虫
䖾	完	虫
䖿	虫	𥝢
䗀	夌	虫
䗁	奇	虫
䗂	虎	虫
䗃	戔	虫
䗄	斧	虫
䗅	虫	長
䗆	官	虫
䗇	匊	虫
䗈	盲	虫
䗉	昌	虫
䗊	炎	虫
䗋	某	虫
䗌	星	虫
䗍	彖	虫
䗎	垔	虫
䗏	叜	虫
䗐	施	虫
䗑	昱	虫
䗒	並	虫
䗓	怱	虫
䗔	侯	虫
䗕	宛	虫
䗖	带	虫
䗗	笄	虫
䗘	盍	虫
䗙	虫	𡨄
䗚	尃	虫
䗛	脩	虫
䗜	留	虫
䗝	神	虫
䗞	䖵	天
䗟	殹	虫
䗠	旋	虫
䗡	焉	虫
䗢	虫	造
䗣	䖵	甘
䗤	庸	虫
䗥	從	虫
䗦	虫	逢
䗧	康	虫
䗨	虫	魚
䗩	戚	虫
䗪	庶	虫
䗫	虫	麻
䗬	虫	逢
䗭	患	虫
䗮	爽	虫
䗯	虫	進
䗰	虫	貫
䗱	菐	虫
䗲	粦	虫
䗳	登	虫
䗴	筳	虫
䗵	畺	虫
䗶	葛	虫
䗷	意	虫
䗸	虫	雍
䗹	慈	虫
䗺	䖵	延
䗻	節	虫
䗼	熏	虫
䗽	維	虫
䗾	㬎	虫
䗿	寧	虫
䘀	䖵	阜
䘁	截	虫
䘂	虫	韯
䘃	墨	虫
䘄	䖵	者
䘅	䖵	能
䘆	憲	虫
䘇	文	蟲
䘈	勵	虫
䘉	䖵	蚕
䘊	篾	虫
䘋	虫	韱
䘌	䖵	匿
䘍	䖵	萬
䘎	彎	虫
䘏	血	阝
䘐	刅	血
䘑	永	血
䘒	夋	血
䘓	臽	血
䘔	客	血
䘕	亍	亢	彳
䘖	亍	彳	缶
䘗	一	亍	山	彳	糸
䘘	亍	彳	素
䘙	亍	帀	彳	韋
䘚	十	衣
䘛	几	衤
䘜	巾	衤
䘝	弋	衤
䘞	衤	马
䘟	弔	衤
䘠	㐅	衤	𠂇
䘡	比	衣
䘢	宁	衤
䘣	此	衤
䘤	术	衤
䘥	甲	衤
䘦	尼	衤
䘧	央	衤
䘨	交	衤
䘩	旬	衤
䘪	充	衤
䘫	如	衣
䘬	戎	衤
䘭	至	衤
䘮	丿	乀	从	土	𠄌
䘯	肖	衤
䘰	延	衤
䘱	亠	谷	𧘇
䘲	衤	𠬶
䘳	衤	金
䘴	松	衤
䘵	彔	衤
䘶	函	衤
䘷	㡀	衤
䘸	夜	衤
䘹	卒	衤
䘺	定	衤
䘻	育	衤
䘼	宛	衤
䘽	兒	衤
䘾	官	衤
䘿	屈	衤
䙀	朋	衤
䙁	戔	衤
䙂	忩	衤
䙃	左	月	衤
䙄	臿	衤
䙅	衤	要
䙆	癸	衤
䙇	耎	衤
䙈	侯	衤
䙉	盾	衤
䙊	带	衤
䙋	宣	衤
䙌	衤	贵
䙍	衤	飛
䙎	奚	衤
䙏	尃	衤
䙐	衤	鬲
䙑	衤	衰
䙒	畜	衤
䙓	罢	衤
䙔	區	衤
䙕	從	衤
䙖	崩	衤
䙗	啇	衤
䙘	戚	衤
䙙	犀	衤
䙚	衣	鳥
䙛	衤	袞
䙜	衤	逢
䙝	亠	執	𧘇
䙞	登	衤
䙟	圍	衤
䙠	厥	衤
䙡	衤	貴
䙢	曾	衤
䙣	䨿	衤
䙤	衤	過
䙥	衤	零
䙦	夢	衤
䙧	熏	衤
䙨	衤	𮖐
䙩	蒙	衤
䙪	樊	衣
䙫	冀	衤
䙬	嬰	衤
䙭	衤	蹇
䙮	衤	雚
䙯	衤	蹙
䙰	衤	離
䙱	屬	衤
䙲	大	覀
䙳	火	覀
䙴	㔾	䙲
䙵	圭	覀
䙶	农	西
䙷	寸	見
䙸	寸	見
䙹	开	見
䙺	火	見
䙻	見	𠂔
䙼	召	見
䙽	見	𡗜
䙾	它	見
䙿	未	見
䚀	舟	見
䚁	向	見
䚂	見	赤
䚃	卣	見
䚄	录	見
䚅	來	見
䚆	英	見
䚇	省	見
䚈	垔	見
䚉	契	見
䚊	益	見
䚋	員	見
䚌	皋	見
䚍	見	責
䚎	舂	見
䚏	粦	見
䚐	智	見
䚑	見	買
䚒	童	見
䚓	覃	見
䚔	見	賓
䚕	見	麗
䚖	見	靈
䚗	公	角
䚘	亍	彳	角
䚙	亘	角
䚚	先	角
䚛	告	角
䚜	卑	角
䚝	卒	角
䚞	來	角
䚟	㝵	角
䚠	昆	角
䚡	思	角
䚢	枼	角
䚣	是	角
䚤	禺	角
䚥	弱	角
䚦	虒	角
䚧	翏	角
䚨	發	角
䚩	喬	角
䚪	睘	角
䚫	敫	角
䚬	粦	角
䚭	角	雚
䚮	乃	言
䚯	刂	言
䚰	匕	言
䚱	小	言
䚲	彡	言
䚳	支	言
䚴	月	言
䚵	斗	言
䚶	天	言
䚷	兮	言
䚸	介	言
䚹	比	言
䚺	攵	言
䚻	⺀	言	𠂊
䚼	丑	言
䚽	毛	言
䚾	壬	言
䚿	欠	言
䛀	反	言
䛁	冄	言
䛂	升	言
䛃	元	言
䛄	夗	言
䛅	甲	言
䛆	由	言
䛇	口	言	𠘧
䛈	矢	言
䛉	民	言
䛊	只	言
䛋	戊	言
䛌	包	言
䛍	弗	言
䛎	穴	言
䛏	尼	言
䛐	司	言
䛑	必	言
䛒	巧	言
䛓	〢	丶	言	𠂉
䛔	而	言
䛕	乂	日	言
䛖	曳	言
䛗	臣	言
䛘	任	言
䛙	休	言
䛚	㓞	言
䛛	回	言
䛜	囟	言
䛝	丑	山	言
䛞	旱	言
䛟	夾	言
䛠	言	豆
䛡	言	𠯑
䛢	秃	言
䛣	甹	言
䛤	言	足
䛥	希	言
䛦	言	谷
䛧	米	言	𠃊
䛨	言	辛
䛩	亞	言
䛪	穹	言
䛫	言	長
䛬	匋	言
䛭	幸	言
䛮	咎	言
䛯	居	言
䛰	昆	言
䛱	忠	言
䛲	帛	言
䛳	奄	言
䛴	奇	言
䛵	受	言
䛶	言	𣐇
䛷	宛	言
䛸	店	言
䛹	彖	言
䛺	界	言
䛻	盾	言
䛼	言	𬛸
䛽	臿	言
䛾	素	言
䛿	言	鬲
䜀	刃	止	言
䜁	奊	言
䜂	皋	言
䜃	土	誰
䜄	犀	言
䜅	崔	言
䜆	言	麻
䜇	衮	言
䜈	巢	言
䜉	桼	言
䜊	曹	言
䜋	言	貴
䜌	糸	言
䜍	尞	言
䜎	勞	言
䜏	言	隋
䜐	言	隋
䜑	惡	言
䜒	奥	言
䜓	葉	言
䜔	言	遀
䜕	萬	言
䜖	言	賈
䜗	感	言
䜘	敬	言
䜙	㬎	言
䜚	言	遝
䜛	言	𭀰
䜜	睿	言
䜝	㡭	言
䜞	言	齊
䜟	言	韯
䜠	言	質
䜡	憂	言
䜢	憲	言
䜣	斤	讠
䜤	共	讠
䜥	廴	旦	讠
䜦	荀	讠
䜧	刃	止	讠
䜨	患	讠
䜩	燕	讠
䜪	九	谷
䜫	工	谷
䜬	由	谷
䜭	谷	𣦵
䜮	牢	谷
䜯	匊	谷
䜰	皋	谷
䜱	曼	谷
䜲	巤	谷
䜳	豆	𠃊
䜴	攴	豆
䜵	皮	豆
䜶	夅	豆
䜷	豆	𠬶
䜸	尾	豆
䜹	束	豆
䜺	昔	豆
䜻	是	豆
䜼	敄	豆
䜽	俞	豆
䜾	豆	音
䜿	一	臣	豆	𠂉
䝀	留	豆
䝁	豆	𤇾
䝂	殳	臣	豆
䝃	㬎	豆
䝄	豆	雙
䝅	土	豕
䝆	勿	豕
䝇	尣	豕
䝈	卮	豕
䝉	④	冖	豕
䝊	疌	豕
䝋	宗	豕
䝌	叕	豕
䝍	豕	軍
䝎	耑	豕
䝏	婁	豕
䝐	豕	隋
䝑	童	豕
䝒	聚	豕
䝓	巤	豕
䝔	豕	雚
䝕	聶	豕
䝖	爪	豸
䝗	木	豸
䝘	殳	豸
䝙	区	豸
䝚	尼	豸
䝛	皮	豸
䝜	夋	豸
䝝	奇	豸
䝞	虎	豸
䝟	契	豸
䝠	原	豸
䝡	㒼	豸
䝢	曼	豸
䝣	渠	豸
䝤	尞	豸
䝥	臯	豸
䝦	衆	豸
䝧	匀	貝
䝨	〢	又	貝
䝩	㐱	貝
䝪	疋	貝
䝫	乍	貝
䝬	主	貝
䝭	句	貝
䝮	玄	貝
䝯	㐌	貝
䝰	寺	貝
䝱	劦	貝
䝲	尽	貝
䝳	貝	𣦼
䝴	一	中	冖	貝
䝵	甫	貝
䝶	京	貝
䝷	知	貝
䝸	芰	貝
䝹	宛	貝
䝺	貝	𪯢
䝻	居	貝
䝼	貝	青
䝽	厓	貝
䝾	武	貝
䝿	臾	貝
䞀	侯	貝
䞁	匽	貝
䞂	耎	貝
䞃	致	貝
䞄	施	貝
䞅	唇	貝
䞆	貝	𧴪
䞇	埶	貝
䞈	爲	貝
䞉	貝	龹
䞊	貝	𧇖
䞋	親	貝
䞌	舌	贝
䞍	贝	青
䞎	昌	贝
䞏	思	贝
䞐	春	贝
䞑	工	赤
䞒	同	赤
䞓	巠	赤
䞔	尾	赤
䞕	赤	需
䞖	弋	走
䞗	才	走
䞘	乞	走
䞙	帀	走
䞚	支	走
䞛	丏	走
䞜	不	走
䞝	玉	走
䞞	弗	走
䞟	白	走
䞠	石	走
䞡	旦	走
䞢	乍	走
䞣	斥	走
䞤	句	走
䞥	有	走
䞦	各	走
䞧	后	走
䞨	圭	走
䞩	合	走
䞪	匠	走
䞫	君	走
䞬	秀	走
䞭	夋	走
䞮	余	走
䞯	孚	走
䞰	赤	走
䞱	谷	走
䞲	我	走
䞳	咅	走
䞴	周	走
䞵	叕	走
䞶	易	走
䞷	屈	走
䞸	口	示	走
䞹	皇	走
䞺	盾	走
䞻	勇	走
䞼	彖	走
䞽	索	走
䞾	虒	走
䞿	走	𡨄
䟀	差	走
䟁	巢	走
䟂	曼	走
䟃	參	走
䟄	責	走
䟅	斬	走
䟆	畢	走
䟇	幾	走
䟈	走	𢧜
䟉	蜀	走
䟊	豦	走
䟋	詹	走
䟌	截	走
䟍	臱	走
䟎	賛	走
䟏	樂	走
䟐	歷	走
䟑	走	龠
䟒	走	雚
䟓	丁	𧾷
䟔	卜	𧾷
䟕	叉	𧾷
䟖	山	𧾷
䟗	氏	𧾷
䟘	亢	𧾷
䟙	切	𧾷
䟚	亓	𧾷
䟛	巿	𧾷
䟜	内	𧾷
䟝	殳	𧾷
䟞	少	𧾷
䟟	斥	足
䟠	戉	𧾷
䟡	氐	𧾷
䟢	尓	𧾷
䟣	术	𧾷
䟤	必	𧾷
䟥	矛	𧾷
䟦	叐	𧾷
䟧	田	𧾷
䟨	民	𧾷
䟩	去	𧾷
䟪	乏	𧾷
䟫	足	龸
䟬	丘	𧾷
䟭	乍	𧾷
䟮	伏	𧾷
䟯	舌	𧾷
䟰	行	𧾷
䟱	朿	𧾷
䟲	充	𧾷
䟳	羽	足
䟴	辰	𧾷
䟵	求	𧾷
䟶	坐	𧾷
䟷	折	𧾷
䟸	𢌳	𧾷
䟹	寽	𧾷
䟺	貝	𧾷
䟻	余	𧾷
䟼	武	𧾷
䟽	㐬	𧾷
䟾	叕	𧾷
䟿	录	𧾷
䠀	尚	𧾷
䠁	亝	𧾷
䠂	林	足
䠃	兩	𧾷
䠄	典	𧾷
䠅	囷	𧾷
䠆	長	𧾷
䠇	屈	𧾷
䠈	隶	𧾷
䠉	官	𧾷
䠊	非	𧾷
䠋	卑	𧾷
䠌	月	水	𧾷
䠍	叚	𧾷
䠎	屋	𧾷
䠏	癸	𧾷
䠐	狊	𧾷
䠑	奎	𧾷
䠒	胡	𧾷
䠓	酋	𧾷
䠔	㒸	𧾷
䠕	柴	𧾷
䠖	咨	𧾷
䠗	臭	𧾷
䠘	𣬉	𧾷
䠙	旁	𧾷
䠚	窊	𧾷
䠛	䍃	𧾷
䠜	茸	𧾷
䠝	員	𧾷
䠞	戚	𧾷
䠟	執	足
䠠	帶	足
䠡	虘	𧾷
䠢	冖	足	𦭝
䠣	巽	𧾷
䠤	單	𧾷
䠥	敝	𧾷
䠦	智	𧾷
䠧	屠	𧾷
䠨	詹	𧾷
䠩	歲	𧾷
䠪	㡭	𧾷
䠫	聚	𧾷
䠬	鄧	𧾷
䠭	賴	𧾷
䠮	駦	𧾷
䠯	龠	𧾷
䠰	雚	𧾷
䠱	屬	𧾷
䠲	令	身
䠳	出	身
䠴	立	身
䠵	付	身
䠶	矢	身
䠷	兆	身
䠸	夸	身
䠹	亥	身
䠺	身	问
䠻	穹	身
䠼	俞	身
䠽	豈	身
䠾	身	閃
䠿	貴	身
䡀	亶	身
䡁	身	龍
䡂	丩	車
䡃	力	車
䡄	几	車
䡅	川	車
䡆	公	車
䡇	元	車
䡈	爻	車
䡉	亢	車
䡊	反	車
䡋	支	車
䡌	厷	車
䡍	夫	車
䡎	戶	車
䡏	弘	車
䡐	它	車
䡑	民	車
䡒	田	車
䡓	亍	彳	車
䡔	多	車
䡕	丞	車
䡖	車	𡉊
䡗	巩	車
䡘	甸	車
䡙	良	車
䡚	皃	車
䡛	車
䡜	坴	車
䡝	宛	車
䡞	大	目	車
䡟	卑	車
䡠	貞	車
䡡	皆	車
䡢	扁	車
䡣	車	軍
䡤	者	車
䡥	容	車
䡦	桑	車
䡧	烏	車
䡨	差	車
䡩	真	車
䡪	扇	車
䡫	車	逢
䡬	曼	車
䡭	羞	車
䡮	從	車
䡯	悤	車
䡰	殸	車
䡱	區	車
䡲	單	車
䡳	斯	車
䡴	童	車
䡵	車	遂
䡶	車	辟
䡷	蓋	車
䡸	戉	車	𦭝
䡹	疐	車
䡺	慧	車
䡻	臱	車
䡼	車	霝
䡽	贊	車
䡾	獻	車
䡿	車	靈
䢀	乞	车
䢁	月	车
䢂	立	车
䢃	乂	辟
䢄	枲	𣓀
䢅	臼	辰
䢆	冗	辱
䢇	宂	辱
䢈	會	辰
䢉	囟	辰	𦥑
䢊	子	辶
䢋	丌	辶
䢌	巿	辶
䢍	方	辶
䢎	开	辶
䢏	斗	辶
䢐	且	辶
䢑	氐	辶
䢒	交	辶
䢓	宇	辶
䢔	合	辶
䢕	戌	辶
䢖	聿	辶
䢗	曲	辶
䢘	守	辶
䢙	貝	辶
䢚	更	辶
䢛	冏	辶
䢜	帚	辶
䢝	亞	辶
䢞	林	辶
䢟	放	辶
䢠	灷	辶
䢡	枼	辶
䢢	倉	辶
䢣	辶	𧥧
䢤	秫	辶
䢥	正	目	辶
䢦	率	辶
䢧	翏	辶
䢨	從	辶
䢩	敔	辶
䢪	喬	辶
䢫	辶	隋
䢬	舜	辶
䢭	羡	辶
䢮	辶	雷
䢯	㷠	辶
䢰	翟	辶
䢱	賣	辶
䢲	矍	辶
䢳	几	阝
䢴	干	阝
䢵	云	阝
䢶	木	阝
䢷	丹	阝
䢸	且	阝
䢹	巨	阝
䢺	出	阝
䢻	臣	阝
䢼	共	阝
䢽	共	邑
䢾	先	阝
䢿	安	阝
䣀	危	阝
䣁	羽	阝
䣂	耒	阝
䣃	阝	𦈢
䣄	余	阝
䣅	辰	阝
䣆	巠	阝
䣇	求	阝
䣈	邑
䣉	沙	邑
䣊	尚	阝
䣋	采	阝
䣌	底	阝
䣍	奄	阝
䣎	甾	阝
䣏	供	阝
䣐	英	阝
䣑	厘	阝
䣒	贵	阝
䣓	阝	鬲
䣔	阝	𧴪
䣕	阝	馬
䣖	邑	馬
䣗	皋	阝
䣘	堂	阝
䣙	崩	阝
䣚	婁	阝
䣛	桼	阝
䣜	虘	阝
䣝	屠	阝
䣞	㖾	阝
䣟	朁	阝
䣠	替	阝
䣡	義	阝
䣢	耤	阝
䣣	阝	黨
䣤	矍	阝
䣥	匕	酉
䣦	力	酉
䣧	弋	酉
䣨	七	丿	酉
䣩	屯	酉
䣪	巿	酉
䣫	支	酉
䣬	戈	酉
䣭	犬	酉
䣮	犮	酉
䣯	且	酉
䣰	巨	酉
䣱	句	酉
䣲	弁	酉
䣳	司	酉
䣴	兇	酉
䣵	耳	酉
䣶	舌	酉
䣷	朱	酉
䣸	任	酉
䣹	伐	酉
䣺	肙	酉
䣻	含	酉
䣼	京	酉
䣽	知	酉
䣾	宜	酉
䣿	盂	酉
䤀	若	酉
䤁	甚	酉
䤂	某	酉
䤃	酉	音
䤄	酉	面
䤅	俞	酉
䤆	癸	酉
䤇	叜	酉
䤈	㿽	酉
䤉	酉	𥁑
䤊	茸	酉
䤋	或	酋
䤌	倉	酉
䤍	㒼	酉
䤎	矞	酉
䤏	酉	𩇮
䤐	朁	酉
䤑	酉	黄
䤒	幾	酉
䤓	蒙	酉
䤔	漸	酉
䤕	樂	酉
䤖	暴	酉
䤗	酉	𥪴
䤘	酉	韱
䤙	蠡	酉
䤚	月	里
䤛	丩	金
䤜	七	丿	金
䤝	卬	金
䤞	尤	金
䤟	冗	金
䤠	止	金
䤡	冉	金
䤢	叧	金
䤣	乎	金
䤤	亥	金
䤥	危	金
䤦	伐	金
䤧	回	金
䤨	金	𠂢
䤩	宅	金
䤪	朵	金
䤫	岑	金
䤬	沙	金
䤭	希	金
䤮	步	金
䤯	形	金
䤰	坎	金
䤱	金	𡵱
䤲	赤	金
䤳	夜	金
䤴	函	金
䤵	金	非
䤶	奄	金
䤷	匽	金
䤸	彖	金
䤹	叜	金
䤺	斫	金
䤻	左	月	金
䤼	泉	金
䤽	眔	金
䤾	舀	金
䤿	挈	金
䥀	蚩	金
䥁	圅	金
䥂	冡	金
䥃	金	隺
䥄	厝	金
䥅	十	玨	金
䥆	亠	金	非
䥇	扇	金
䥈	莽	金
䥉	寃	金
䥊	責	金
䥋	烹	金
䥌	宀	昍	金
䥍	執	金
䥎	脣	金
䥏	御	金
䥐	務	金
䥑	金	麥
䥒	強	金
䥓	基	金
䥔	粟	金
䥕	敝	金
䥖	奠	金
䥗	款	金
䥘	㫺	金
䥙	金	隊
䥚	䀠	几	金
䥛	絜	金
䥜	金	閑
䥝	金	麀
䥞	敫	金
䥟	揭	金
䥠	葴	金
䥡	牒	金
䥢	金	鼓
䥣	毀	金
䥤	金	雹
䥥	亷	金
䥦	遀	金
䥧	金	𥈠
䥨	金	閭
䥩	微	金
䥪	㬎	金
䥫	截	金
䥬	蒪	金
䥭	求	金
䥮	卩	臣	覀	金
䥯	罷	金
䥰	蝱	金
䥱	寫	金
䥲	歐	金
䥳	憂	金
䥴	嶲	金
䥵	曉	金
䥶	歷	金
䥷	㔍	金
䥸	彌	金
䥹	金	齧
䥺	牙	钅
䥻	无	钅
䥼	勿	钅
䥽	发	钅
䥾	写	钅
䥿	万	钅	𠂆
䦀	羽	钅
䦁	邦	钅
䦂	扇	钅
䦃	著	钅
䦄	⑧	钅	𧘇
䦅	善	钅
䦆	矍	钅
䦇	㇉	八	镸
䦈	左	镸
䦉	四	镸
䦊	尗	镸
䦋	敖	镸
䦌	土	門
䦍	乞	門
䦎	元	門
䦏	介	門
䦐	手	門
䦑	夬	門
䦒	石	門
䦓	占	門
䦔	旦	門
䦕	并	門
䦖	吉	門
䦗	血	門
䦘	艮	門
䦙	寺	門
䦚	舌	門
䦛	争	門
䦜	吾	門
䦝	赤	門
䦞	汪	門
䦟	坐	門
䦠	豖	門
䦡	官	門
䦢	法	門
䦣	咅	門
䦤	叕	門
䦥	林	門
䦦	金	門
䦧	兒	門
䦨	東	門
䦩	門	𡕥
䦪	曷	門
䦫	英	門
䦬	契	門
䦭	門	香
䦮	春	門
䦯	致	門
䦰	亀	門
䦱	爲	門
䦲	詹	門
䦳	鄉	門
䦴	睪	門
䦵	爾	門
䦶	争	门
䦷	坐	门
䦸	禺	门
䦹	十	阝
䦺	丁	阝
䦻	子	阝
䦼	夬	阝
䦽	予	阝
䦾	允	𠂤
䦿	中	阝
䧀	厷	阝
䧁	句	阝
䧂	召	阝
䧃	田	阝
䧄	各	阝
䧅	夷	阝
䧆	共	阝
䧇	衣	阝
䧈	覀	阝
䧉	里	阝
䧊	告	阝
䧋	見	阝
䧌	妥	阝
䧍	谷	阝
䧎	肙	阝
䧏	夆	阝
䧐	享	阝
䧑	定	阝
䧒	來	阝
䧓	周	阝
䧔	念	阝
䧕	或	阝
䧖	戔	阝
䧗	复	阝
䧘	彖	阝
䧙	山	阝	𠇍
䧚	阝	高
䧛	旁	阝
䧜	唐	阝
䧝	蚩	阝
䧞	阝	馬
䧟	舀	阝
䧠	專	阝
䧡	庸	阝
䧢	區	阝
䧣	票	阝
䧤	菐	阝
䧥	惠	阝
䧦	爲	阝
䧧	義	阝
䧨	業	阝
䧩	敢	阝
䧪	女	阝	𢈙
䧫	豪	阝
䧬	賓	阝
䧭	丿	囗	心	阝	𠂭
䧮	憲	阝
䧯	毚	阝
䧰	阝	鯀
䧱	九	隹
䧲	干	隹
䧳	止	隹
䧴	支	隹
䧵	冘	隹
䧶	六	隹
䧷	冬	隹
䧸	古	隹
䧹	倠	广
䧺	右	隹
䧻	合	隹
䧼	告	隹
䧽	釆	隹
䧾	舍	隹
䧿	昔	隹
䨀	籴	隹
䨁	敄	隹
䨂	秋	隹
䨃	晏	隹
䨄	酓	隹
䨅	尞	隹
䨆	敝	隹
䨇	隻
䨈	賓	隹
䨉	嬰	隹
䨊	雥	𣶒
䨋	乇	雨
䨌	元	雨
䨍	井	雨
䨎	弘	雨
䨏	次	雨
䨐	合	雨
䨑	夷	雨
䨒	羽	雨
䨓	回	雨
䨔	光	雨
䨕	汙	雨
䨖	有	雨
䨗	孚	雨
䨘	見	雨
䨙	雨	𭯺
䨚	忽	雨
䨛	析	雨
䨜	朋	雨
䨝	雨	青
䨞	禹	雨
䨟	洼	雨
䨠	曷	雨
䨡	函	雨
䨢	甚	雨
䨣	雨	革
䨤	迪	雨
䨥	隻	雨
䨦	旁	雨
䨧	竛	雨
䨨	追	雨
䨩	神	雨
䨪	埋	雨
䨫	雨	麥
䨬	淋	雨
䨭	肖	雲
䨮	彗	雨
䨯	陳	雨
䨰	㴖	雨
䨱	復	雨
䨲	兔	需
䨳	覞	雨
䨴	對	雨
䨵	潭	雨
䨶	厶	雨	鼎
䨷	雨	𢿨
䨸	隱	雨
䨹	儵	雨
䨺	雲
䨻	雷
䨼	蒦	青
䨽	己	非
䨾	广	非
䨿	天	非
䩀	貝	非
䩁	毳	非
䩂	今	面
䩃	比	面
䩄	见	面
䩅	皮	面
䩆	乍	面
䩇	占	面
䩈	每	面
䩉	甫	面
䩊	宛	面
䩋	面	麻
䩌	焦	面
䩍	尞	面
䩎	僉	面
䩏	蔑	面
䩐	乞	革
䩑	弓	革
䩒	于	革
䩓	勾	革
䩔	殳	革
䩕	卬	革
䩖	少	革
䩗	月	革
䩘	革	𢆰
䩙	玄	革
䩚	氐	革
䩛	必	革
䩜	由	革
䩝	瓜	革
䩞	占	革
䩟	夷	革
䩠	廷	革
䩡	夾	革
䩢	折	革
䩣	余	革
䩤	見	革
䩥	延	革
䩦	攸	革
䩧	言	革
䩨	長	革
䩩	宛	革
䩪	官	革
䩫	兩	革
䩬	奉	革
䩭	奇	革
䩮	录	革
䩯	亟	革
䩰	咠	革
䩱	俞	革
䩲	度	革
䩳	叜	革
䩴	胡	革
䩵	軍	革
䩶	蚩	革
䩷	旁	革
䩸	茸	革
䩹	革	鬲
䩺	翁	革
䩻	革	馬
䩼	逢	革
䩽	區	革
䩾	庶	革
䩿	賁	革
䪀	悹	革
䪁	菐	革
䪂	棘	革
䪃	敦	革
䪄	革	黃
䪅	蜀	革
䪆	豊	革
䪇	蒪	革
䪈	遣	革
䪉	巤	革
䪊	革	龍
䪋	遺	革
䪌	毚	革
䪍	闌	革
䪎	巂	革
䪏	内	韋
䪐	必	韋
䪑	它	韋
䪒	主	韋
䪓	占	韋
䪔	甫	韋
䪕	匊	韋
䪖	复	韋
䪗	叚	韋
䪘	是	韋
䪙	尃	韋
䪚	韋	𦐇
䪛	番	韋
䪜	詹	韋
䪝	蒦	韋
䪞	天	韭
䪟	又	巿	韭
䪠	欠	韭	𠂔
䪡	次	韭	𠂔
䪢	次	韭	𠂔
䪣	次	韭	𪩲
䪤	番	韭
䪥	又	貝	韭	𣦵
䪦	工	音
䪧	也	音
䪨	勺	音
䪩	今	音
䪪	加	音
䪫	巠	音
䪬	孛	音
䪭	音
䪮	芻	音
䪯	音	𤇾
䪰	意	音
䪱	己	頁
䪲	兀	頁
䪳	尹	頁
䪴	冘	頁
䪵	牙	頁
䪶	且	頁
䪷	句	頁
䪸	民	頁
䪹	丕	頁
䪺	去	頁
䪻	弁	頁
䪼	出	頁
䪽	号	頁
䪾	㐱	頁
䪿	囟	頁
䫀	⑤	頁
䫁	自	頁
䫂	多	頁
䫃	辰	頁
䫄	兑	頁
䫅	宋	頁
䫆	成	頁
䫇	冄	彡	頁
䫈	岑	頁
䫉	豸	頁
䫊	否	頁
䫋	委	頁
䫌	卑	頁
䫍	非	頁
䫎	叕	頁
䫏	其	頁
䫐	林	頁
䫑	奇	頁
䫒	昏	頁
䫓	咅	頁
䫔	契	頁
䫕	帝	頁
䫖	甚	頁
䫗	叚	頁
䫘	曷	頁
䫙	桒	頁
䫚	咼	頁
䫛	侯	頁
䫜	幽	頁
䫝	頁	香
䫞	羔	頁
䫟	員	頁
䫠	否	彡	頁
䫡	兼	頁
䫢	虒	頁
䫣	奚	頁
䫤	冥	頁
䫥	頁	鬼
䫦	盍	頁
䫧	皋	頁
䫨	敖	頁
䫩	參	頁
䫪	爽	頁
䫫	婁	頁
䫬	朁	頁
䫭	貴	頁
䫮	尋	頁
䫯	旑	頁
䫰	粦	頁
䫱	頁	𦓔
䫲	感	頁
䫳	蜀	頁
䫴	禁	頁
䫵	臱	頁
䫶	樊	頁
䫷	噩	頁
䫸	刀	風
䫹	工	風
䫺	厷	風
䫻	日	風
䫼	夬	風
䫽	毛	風
䫾	必	風
䫿	召	風
䬀	幼	風
䬁	它	風
䬂	戉	風
䬃	立	風
䬄	戍	風
䬅	劦	風
䬆	利	風
䬇	兑	風
䬈	兑	風
䬉	赤	風
䬊	夾	風
䬋	夌	風
䬌	虎	風
䬍	忽	風
䬎	或	風
䬏	咅	風
䬐	委	風
䬑	胃	風
䬒	叜	風
䬓	音	風
䬔	俞	風
䬕	風
䬖	皇	風
䬗	昜	風
䬘	風	高
䬙	䍃	風
䬚	風	馬
䬛	畢	風
䬜	离	風
䬝	風	黄
䬞	壽	風
䬟	劉	風
䬠	雨	飛
䬡	者	飛
䬢	刀	飠
䬣	乞	飠
䬤	尸	食
䬥	弋	食
䬦	殳	飠
䬧	元	飠
䬨	勼	飠
䬩	不	食
䬪	不	飠
䬫	氐	飠
䬬	央	飠
䬭	叨	食
䬮	以	飠
䬯	占	飠
䬰	召	飠
䬱	本	飠
䬲	句	飠
䬳	半	飠
䬴	末	飠
䬵	亥	飠
䬶	艮	飠
䬷	多	飠
䬸	又	歹	食
䬹	至	飠
䬺	羊	飠
䬻	㦮	飠
䬼	肙	飠
䬽	兑	飠
䬾	弟	飠
䬿	尾	飠
䭀	迅	飠
䭁	折	食
䭂	邑	飠
䭃	念	飠
䭄	事	飠
䭅	固	飠
䭆	卧	食
䭇	勹	吉	飠
䭈	建	飠
䭉	左	月	飠
䭊	英	飠
䭋	保	飠
䭌	胡	食
䭍	皿	飠	龶
䭎	枼	飠
䭏	扁	𩙿
䭐	恙	飠
䭑	兼	飠
䭒	息	飠
䭓	豈	飠
䭔	追	飠
䭕	斬	食
䭖	庶	飠
䭗	竟	飠
䭘	景	飠
䭙	朁	飠
䭚	童	飠
䭛	敢	飠
䭜	尞	𩙿
䭝	會	飠
䭞	睪	飠
䭟	葉	飠
䭠	廉	飠
䭡	㥯	飠
䭢	寧	飠
䭣	飠	齊
䭤	遣	飠
䭥	飠	養
䭦	薄	飠
䭧	縻	飠
䭨	巂	飠
䭩	靡	飠
䭪	量	饣
䭫	旨	首
䭬	旨	𩠐
䭭	頁	首
䭮	首	髟
䭯	出	香
䭰	奉	香
䭱	㡀	香
䭲	奇	香
䭳	香	魏
䭴	十	馬
䭵	凡	馬
䭶	丌	馬
䭷	毛	馬
䭸	父	馬
䭹	卬	馬
䭺	亢	馬
䭻	分	馬
䭼	亓	馬
䭽	牛	馬
䭾	犬	馬
䭿	失	馬
䮀	包	馬
䮁	弁	馬
䮂	犮	馬
䮃	去	馬
䮄	玄	馬
䮅	戉	馬
䮆	㔻	馬
䮇	聿	馬
䮈	多	馬
䮉	④	馬	𠂉
䮊	夷	馬
䮋	列	馬
䮌	休	馬
䮍	衣	馬
䮎	希	馬
䮏	吾	馬
䮐	冏	馬
䮑	寽	馬
䮒	甫	馬
䮓	卓	馬
䮔	垂	馬
䮕	叕	馬
䮖	昌	馬
䮗	岸	馬
䮘	兒	馬
䮙	或	馬
䮚	夌	馬
䮛	附	馬
䮜	枼	馬
䮝	軍	馬
䮞	春	馬
䮟	叜	馬
䮠	畐	馬
䮡	复	馬
䮢	臿	馬
䮣	桑	馬
䮤	隺	馬
䮥	馬	鬲
䮦	馬	高
䮧	馬	𠂉	𠦝
䮨	宰	馬
䮩	馬	骨
䮪	桀	馬
䮫	婁	馬
䮬	莫	馬
䮭	覓	馬
䮮	馬	麥
䮯	敖	馬
䮰	啇	馬
䮱	逐	馬
䮲	馬	黃
䮳	番	馬
䮴	登	馬
䮵	童	馬
䮶	集	馬
䮷	蜀	馬
䮸	馬	𦥯
䮹	歲	馬
䮺	馬	齊
䮻	壽	馬
䮼	㷠	馬
䮽	馬	麃
䮾	馬	龍
䮿	蹇	馬
䯀	聶	馬
䯁	羸	馬
䯂	木	驫
䯃	安	马
䯄	呙	马
䯅	聂	马
䯆	乚	骨
䯇	力	骨
䯈	元	骨
䯉	欠	骨
䯊	可	骨
䯋	犮	骨
䯌	尻	骨
䯍	令	骨
䯎	八	干	骨
䯏	舌	骨
䯐	肉	骨
䯑	光	骨
䯒	行	骨
䯓	圭	骨
䯔	宅	骨
䯕	廷	骨
䯖	良	骨
䯗	坒	骨
䯘	完	骨
䯙	甫	骨
䯚	幺	月	骨
䯛	宛	骨
䯜	易	骨
䯝	左	月	骨
䯞	咼	骨
䯟	㒸	骨
䯠	昷	骨
䯡	兼	骨
䯢	骨	麻
䯣	貴	骨
䯤	會	骨
䯥	㬎	骨
䯦	蔑	骨
䯧	亠	冋	冖	口
䯨	大	高
䯩	巴	高
䯪	頁	高
䯫	景	高
䯬	單	𩫏
䯭	又	髟
䯮	乃	髟
䯯	少	髟
䯰	介	髟
䯱	不	髟
䯲	巴	髟
䯳	公	髟
䯴	殳	髟
䯵	卉	髟
䯶	且	髟
䯷	戎	髟
䯸	次	髟
䯹	髟	𠬶
䯺	髟	𠯑
䯻	告	髟
䯼	狄	髟
䯽	咅	髟
䯾	周	髟
䯿	卒	髟
䰀	委	髟
䰁	录	髟
䰂	采	髟
䰃	並	髟
䰄	思	髟
䰅	頁	髟
䰆	柔	髟
䰇	者	髟
䰈	差	髟
䰉	般	髟
䰊	尃	髟
䰋	晏	髟
䰌	從	髟
䰍	桼	髟
䰎	貴	髟
䰏	截	髟
䰐	監	髟
䰑	需	髟
䰒	蒙	髟
䰓	臱	髟
䰔	盤	髟
䰕	盧	髟
䰖	贊	髟
䰗	鬥	黾	𠂊
䰘	翏	鬥
䰙	支	鬲
䰚	文	鬲
䰛	瓦	鬲
䰜	弓	鬲
䰝	曾	鬲
䰞	弓	者	鬲
䰟	云	鬼
䰠	申	鬼
䰡	失	鬼
䰢	行	鬼
䰣	网	鬼
䰤	東	鬼
䰥	或	鬼
䰦	卑	鬼
䰧	虎	鬼
䰨	眉	鬼
䰩	者	鬼
䰪	脊	鬼
䰫	堯	鬼
䰬	矞	鬼
䰭	鬼	𦓔
䰮	義	鬼
䰯	疑	鬼
䰰	需	鬼
䰱	靈	鬼
䰲	乚	魚
䰳	丁	魚
䰴	乞	魚
䰵	子	魚
䰶	亡	魚
䰷	丰	魚
䰸	公	魚
䰹	戈	魚
䰺	斤	魚
䰻	攵	魚
䰼	今	魚
䰽	巿	魚
䰾	巴	魚
䰿	㐌	魚
䱀	央	魚
䱁	本	魚
䱂	幼	魚
䱃	失	魚
䱄	瓜	魚
䱅	末	魚
䱆	孕	魚
䱇	旦	魚
䱈	示	魚
䱉	且	魚
䱊	米	魚
䱋	共	魚
䱌	魚	𦣞
䱍	亙	魚
䱎	亘	魚
䱏	豆	魚
䱐	孚	魚
䱑	折	魚
䱒	邑	魚
䱓	廷	魚
䱔	攸	魚
䱕	每	魚
䱖	丣	魚
䱗	魚	𣦼
䱘	利	魚
䱙	叔	魚
䱚	录	魚
䱛	或	魚
䱜	昔	魚
䱝	卑	魚
䱞	奈	魚
䱟	居	魚
䱠	戔	魚
䱡	匊	魚
䱢	争	魚
䱣	卒	魚
䱤	臽	魚
䱥	制	魚
䱦	隹	魚
䱧	卷	魚
䱨	刺	魚
䱩	罔	魚
䱪	表	魚
䱫	剌	魚
䱬	胥	魚
䱭	恆	魚
䱮	契	魚
䱯	敄	魚
䱰	重	魚
䱱	帝	魚
䱲	彖	魚
䱳	厘	魚
䱴	恒	魚
䱵	翁	魚
䱶	郞	魚
䱷	攵	𫊣
䱸	叟	魚
䱹	差	魚
䱺	豈	魚
䱻	骨	魚
䱼	展	魚
䱽	倉	魚
䱾	婁	魚
䱿	斬	魚
䲀	執	魚
䲁	尉	魚
䲂	旋	魚
䲃	巢	魚
䲄	敏	魚
䲅	規	魚
䲆	魚
䲇	速	魚
䲈	魚	麻
䲉	斯	魚
䲊	隋	魚
䲋	替	魚
䲌	款	魚
䲍	舟	鮝
䲎	敢	魚
䲏	勞	魚
䲐	虜	魚
䲑	義	魚
䲒	解	魚
䲓	僉	魚
䲔	畺	魚
䲕	普	魚
䲖	壽	魚
䲗	銜	魚
䲘	管	魚
䲙	節	魚
䲚	賴	魚
䲛	瞢	魚
䲜	𩺰
䲝	仓	鱼
䲞	立	鱼
䲟	印	鱼
䲠	春	鱼
䲡	酋	鱼
䲢	⺼	鲞
䲣	攵	虍	鱼
䲤	酒	鱼
䲥	九	鳥
䲦	大	鳥
䲧	土	鳥
䲨	工	鳥
䲩	尸	鳥
䲪	大	鳥
䲫	兀	鳥
䲬	氏	鳥
䲭	氏	鳥
䲮	元	鳥
䲯	及	鳥
䲰	云	鳥
䲱	方	鳥
䲲	公	鳥
䲳	亢	鳥
䲴	火	鳥
䲵	少	鳥
䲶	元	鳥
䲷	木	鳥
䲸	介	鳥
䲹	丕	鳥
䲺	甘	鳥
䲻	玄	鳥
䲼	生	鳥
䲽	石	鳥
䲾	巧	鳥
䲿	尼	鳥
䳀	失	鳥
䳁	犮	鳥
䳂	召	鳥
䳃	夗	鳥
䳄	此	鳥
䳅	只	鳥
䳆	白	鳥
䳇	母	鳥
䳈	包	鳥
䳉	冬	鳥
䳊	犮	鳥
䳋	虫	鳥
䳌	䏍	鳥
䳍	共	鳥
䳎	臼	鳥
䳏	圭	鳥
䳐	次	鳥
䳑	有	鳥
䳒	鳥	𢦏
䳓	老	鳥
䳔	臼	鳥
䳕	孚	鳥
䳖	鳥	𦔮
䳗	我	鳥
䳘	我	鳥
䳙	甹	鳥
䳚	旱	鳥
䳛	妟	鳥
䳜	余	鳥
䳝	咅	鳥
䳞	奉	鳥
䳟	明	鳥
䳠	垂	鳥
䳡	隹	鳥
䳢	其	鳥
䳣	㦲	鳥
䳤	㡀	鳥
䳥	岺	鳥
䳦	宣	鳥
䳧	侯	鳥
䳨	皇	鳥
䳩	要	鳥
䳪	耑	鳥
䳫	癸	鳥
䳬	革	鳥
䳭	即	鳥
䳮	脉	鳥
䳯	重	鳥
䳰	保	鳥
䳱	務	鳥
䳲	振	鳥
䳳	祟	鳥
䳴	眔	鳥
䳵	勑	鳥
䳶	奚	鳥
䳷	從	鳥
䳸	鳥	麻
䳹	寇	鳥
䳺	酓	鳥
䳻	斬	鳥
䳼	區	鳥
䳽	崔	鳥
䳾	登	鳥
䳿	然	鳥
䴀	童	鳥
䴁	寓	鳥
䴂	象	鳥
䴃	堯	鳥
䴄	舜	鳥
䴅	賁	鳥
䴆	菐	鳥
䴇	零	鳥
䴈	奧	鳥
䴉	睘	鳥
䴊	義	鳥
䴋	睘	鳥
䴌	蒙	鳥
䴍	賏	鳥
䴎	畾	鳥
䴏	燕	鳥
䴐	寶	鳥
䴑	宜	畾	鳥
䴒	靈	鳥
䴓	帀	鸟
䴔	交	鸟
䴕	列	鸟
䴖	青	鸟
䴗	狊	鸟
䴘	虒	鸟
䴙	辟	鸟
䴚	亢	鹵
䴛	肖	鹵
䴜	鬼	鹵
䴝	最	鹵
䴞	翟	鹵
䴟	凡	鹿
䴠	夭	鹿
䴡	コ	严	丨	比
䴢	木	鹿
䴣	乎	鹿
䴤	生	鹿
䴥	加	鹿
䴦	言	鹿
䴧	委	鹿
䴨	原	鹿
䴩	票	鹿
䴪	祿	鹿
䴫	零	鹿
䴬	弋	麥
䴭	才	麥
䴮	山	麥
䴯	勿	麥
䴰	戈	麥
䴱	它	麥
䴲	末	麥
䴳	穴	麥
䴴	占	麥
䴵	并	麥
䴶	夆	麥
䴷	完	麥
䴸	孚	麥
䴹	果	麥
䴺	咅	麥
䴻	麥	𥝢
䴼	戔	麥
䴽	卑	麥
䴾	差	麥
䴿	冡	麥
䵀	麥	𧴪
䵁	將	麥
䵂	啇	麥
䵃	麥	黄
䵄	豊	麥
䵅	敖	麥
䵆	蒙	麥
䵇	攵	麻
䵈	後	麻
䵉	俞	麻
䵊	丹	黃
䵋	有	黄
䵌	夾	黄
䵍	享	黄
䵎	耑	黄
䵏	翏	黄
䵐	單	黄
䵑	刃	黍
䵒	日	黍
䵓	牛	黍
䵔	東	黍
䵕	居	黍
䵖	臤	黍
䵗	畐	黍
䵘	昜	黍
䵙	奓	黍
䵚	舀	黍
䵛	堅	黍
䵜	農	黍
䵝	乚	黑
䵞	刂	黑
䵟	干	黑
䵠	勺	黑
䵡	天	黑
䵢	未	黑
䵣	旦	黑
䵤	开	黑
䵥	色	黑
䵦	汙	黑
䵧	黑	𢦏
䵨	尨	黑
䵩	利	黑
䵪	昆	黑
䵫	宛	黑
䵬	沓	黑
䵭	者	黑
䵮	昜	黑
䵯	重	黑
䵰	黑	𬀷
䵱	喜	黑
䵲	喿	黑
䵳	會	黑
䵴	黑	黽
䵵	黑	𮅕
䵶	句	黽
䵷	圭	黽
䵸	秋	黽
䵹	黽	𥎿
䵺	土	鼎
䵻	彗	鼎
䵼	將	鼎
䵽	去	鼓
䵾	付	鼓
䵿	占	鼓
䶀	合	鼓
䶁	沓	鼓
䶂	勺	鼠
䶃	今	鼠
䶄	平	鼠
䶅	各	鼠
䶆	隹	鼠
䶇	胄	鼠
䶈	尃	鼠
䶉	留	鼠
䶊	丑	鼻
䶋	及	鼻
䶌	包	鼻
䶍	至	鼻
䶎	合	鼻
䶏	弟	鼻
䶐	會	鼻
䶑	鼻	𤴡
䶒	女	齊
䶓	巾	齊
䶔	也	齒
䶕	巴	齒
䶖	今	齒
䶗	可	齒
䶘	立	齒
䶙	巨	齒
䶚	虫	齒
䶛	列	齒
䶜	告	齒
䶝	夾	齒
䶞	其	齒
䶟	臽	齒
䶠	咸	齒
䶡	則	齒
䶢	咸	齒
䶣	豈	齒
䶤	骨	齒
䶥	虘	齒
䶦	責	齒
䶧	堯	齒
䶨	僉	齒
䶩	齊	齒
䶪	截	齒
䶫	嚴	齒
䶬	幵	龍
䶭	王	龙
䶮	天	龙
䶯	女	龜
䶰	毛	龜
䶱	冬	龜
䶲	冉	龜
䶳	亢	龠
䶴	炊	龠
䶵	虒	龠
豈	山	豆
更	一	乂	日
車	車
賈	覀	貝
滑	氵	骨
串	丨	吕
句	勹	口
龜	龜
龜	龜
契	㓞	大
金	丷	人	王
喇	剌	口
奈	大	示
懶	忄	賴
癩	疒	賴
羅	維	罒
蘿	羅	艹
螺	累	虫
裸	果	衤
邏	羅	辶
樂	幺	木	白
洛	各	氵
烙	各	火
珞	各	王
落	洛	艹
酪	各	酉
駱	各	馬
亂	乚	𤔔
卵	卪	𠂑
欄	木	闌
爛	火	闌
蘭	艹	闌
鸞	䜌	鳥
嵐	山	風
濫	氵	監
藍	監	艹
襤	監	衤
拉	扌	立
臘	巤	月
蠟	巤	虫
廊	广	郞
朗	月	良
浪	氵	良
狼	犭	良
郎	⑤	丶	阝
來	从	木
冷	令	冫
勞	力	𤇾
擄	扌	虜
櫓	木	魯
爐	火	盧
盧	田	皿	虍
老	匕	耂
蘆	盧	艹
虜	力	毌	虍
路	各	𧾷
露	路	雨
魯	日	魚
鷺	路	鳥
碌	彔	石
祿	彔	示
綠	彔	糸
菉	彔	艹
錄	彔	金
鹿	コ	丨	广	比
論	侖	言
壟	土	龍
弄	廾	王
籠	竹	龍
聾	耳	龍
牢	宀	牛
磊	石	砳
賂	各	貝
雷	田	雨
壘	土	畾
屢	婁	尸
樓	婁	木
淚	戾	氵
漏	屚	氵
累	田	糸
縷	婁	糸
陋	阝	𫠥
勒	力	革
肋	力	月
凜	冫	稟
凌	冫	夌
稜	夌	禾
綾	夌	糸
菱	夌	艹
陵	夌	阝
讀	言	賣
拏	奴	手
樂	幺	木	白
諾	若	言
丹	丹
寧	丁	罒	𫲽
怒	奴	心
率	丷	八	十	玄
異	共	田
北	③	匕
磻	番	石
便	亻	更
復	复	彳
不	③	一
泌	必	氵
數	婁	攵
索	冖	十	糸
參	㐱	厽
塞	土	𡨄
省	少	目
葉	枼	艹
說	兌	言
殺	殳	𣏂
辰	丿	乀	二	厂	𠄌
沈	冘	氵
拾	合	扌
若	右	艹
掠	京	扌
略	各	田
亮	亠	儿	冖	口
兩	一	巾	𠓜
凉	京	冫
梁	刅	木	氵
糧	米	量
良	丨	艮
諒	京	言
量	旦	里
勵	力	厲
呂	丿	口
女	女
廬	广	盧
旅	④	方	𠂉
濾	慮	氵
礪	厲	石
閭	呂	門
驪	馬	麗
麗	鹿	丽
黎	人	氺	𥝢
力	丿	𠃌
曆	厤	日
歷	厤	止
轢	樂	車
年	年
憐	忄	粦
戀	䜌	心
撚	扌	然
漣	氵	連
煉	柬	火
璉	王	連
秊	千	禾
練	柬	糸
聯	耳	𢇇
輦	㚘	車
蓮	艹	連
連	車	辶
鍊	柬	金
列	刂	歹
劣	力	少
咽	口	因
烈	列	灬
裂	列	衣
說	兌	言
廉	兼	广
念	今	心
捻	念	扌
殮	僉	歹
簾	廉	竹
獵	巤	犭
令	丨	亼	𠃌
囹	令	囗
寧	丁	寍
嶺	山	領
怜	令	忄
玲	令	王
瑩	玉	𤇾
羚	令	羊
聆	令	耳
鈴	令	金
零	令	雨
靈	巫	霝
領	令	頁
例	亻	列
禮	示	豊
醴	豊	酉
隸	柰	隶
惡	亞	心
了	乛	亅
僚	亻	尞
寮	宀	尞
尿	尸	水
料	斗	米
樂	幺	木	白
燎	尞	火
療	尞	疒
蓼	翏	艹
遼	尞	辶
龍	⑦	𦚏
暈	日	軍
阮	元	阝
劉	③	刀	刂	金
杻	丑	木
柳	卯	木
流	㐬	氵
溜	氵	留
琉	㐬	王
留	③	刀	田
硫	㐬	石
紐	丑	糸
類	頁	类
六	亠	八
戮	戈	翏
陸	坴	阝
倫	亻	侖
崙	侖	山
淪	侖	氵
輪	侖	車
律	彳	聿
慄	忄	栗
栗	木	覀
率	丷	八	十	玄
隆	㚅	阝
利	刂	禾
吏	一	史
履	尸	復
易	勿	日
李	子	木
梨	利	木
泥	尼	氵
理	王	里
痢	利	疒
罹	惟	罒
裏	亠	里	𧘇
裡	衤	里
里	一	甲
離	离	隹
匿	匚	若
溺	弱	氵
吝	口	文
燐	火	粦
璘	王	粦
藺	艹	閵
隣	粦	阝
鱗	粦	魚
麟	粦	鹿
林	木
淋	林	氵
臨	品	臣	𠂉
立	一	丷	亠
笠	立	竹
粒	立	米
狀	爿	犬
炙	⺀	火	𠂊
識	戠	言
什	亻	十
茶	人	朩	艹
刺	刂	朿
切	七	刀
度	又	广	廿
拓	扌	石
糖	唐	米
宅	乇	宀
洞	同	氵
暴	㳟	日
輻	畐	車
行	亍	彳
降	夅	阝
見	儿	目
廓	广	郭
兀	一	儿
嗀	殳	𫯁
﨎	又	𮥷
﨏	土	谷
塚	冢	土
﨑	山	竒
晴	日	靑
﨓	木	苻
﨔	挙	木
凞	冫	巳	灬	臣
猪	犭	者
益	一	八	皿
礼	乚	示
神	申	示
祥	示	羊
福	畐	示
靖	立	靑
精	米	靑
羽	丿	𠃌
﨟	艹	𦝲
蘒	艹	龝
﨡	生	虫
諸	言	者
﨣	斗	走
﨤	及	辶
逸	兔	辶
都	阝	者
﨧	孝	金
﨨	幸	金
﨩	島	阝
飯	反	𩙿
飼	司	𩙿
館	官	𩙿
鶴	寉	鳥
郞	良	阝
隷	士	示	隶
侮	亻	每
僧	亻	曾
免	⑤	刀
勉	免	力
勤	力	堇
卑	卑
喝	口	曷
嘆	口	夫	廿
器	吅	犬
塀	土	屛
墨	土	黑
層	尸	曾
屮	丨	凵
悔	忄	每
慨	忄	既
憎	忄	曾
懲	徵	心
敏	攵	每
既	既
暑	日	者
梅	木	每
海	每	氵
渚	氵	者
漢	口	夫	廿	氵
煮	灬	者
爫	丿	𭕄
琢	王	豖
碑	石	卑
社	土	示
祉	止	示
祈	斤	示
祐	右	示
祖	且	示
祝	兄	示
禍	咼	示
禎	示	貞
穀	殳	𥞤
突	犬	穴
節	竹	即
練	柬	糸
縉	晋	糸
繁	敏	糸
署	罒	者
者	者
臭	犬	自
艹	艹
艹	十
著	艹	者
褐	曷	衤
視	示	見
謁	曷	言
謹	堇	言
賓	一	宀	貝	𣥂
贈	曾	貝
辶	辶
逸	兔	辶
難	口	夫	廿	隹
響	鄕	音
頻	步	頁
恵	丶	心	𤰔
𤋮	灬	𭘍
舘	官	舎
並	⑥	䒑
况	二	兄
全	人	王
侀	亻	𠛬
充	儿	𠫓
冀	北	異
勇	力	甬
勺	丶	勹
喝	匂	口	日
啕	勹	口	𦈢
喙	口	彐	𧰨
嗢	口	昷
塚	冖	土	豕
墳	土	賁
奄	乚	大	日
奔	大	卉
婢	女	𤰞
嬨	女	心	玆
廒	广	敖
廙	广	異
彩	彡	釆
徭	彳	爫	𠙻
惘	㒺	忄
慎	且	八	十	忄
愈	刖	心	𠓛
憎	八	忄	日	田
慠	忄	敖
懲	徴	心
戴	𢦏	異
揄	刖	扌	𠓛
搜	又	扌	𦥔
摒	土	屏
敖	攵	𫠤
晴	日	青
朗	⑤	丶	月
望	⺀	亡	𠂊	𡈼
杖	木	𠀋
歹	一	夂
殺	杀	殳
流	氵	𠫓	𫶧
滛	氵	爫	𠙻
滋	氵	玆
漢	氵	𦰩
瀞	氵	靜
煮	灬	者
瞧	灬	睢
爵	⑤	寸	爫	罒
犯	巳	犭
猪	犭	者
瑱	王	真
甆	玆	瓦
画	一	凵	由
瘝	水	疒	罒
瘟	昷	疒
益	䒑	八	皿
盛	皿	成
直	一	且	十
睊	䏍	目
着	目	羊
磌	真	石
窱	丨	亻	夂	朩	穴
節	即	竹
类	犬	米
絛	丨	亻	夂	糸
練	東	糸
缾	幷	缶
者	日	耂
荒	兦	艹	𫶧
華	華
蝹	虫	𥁕
襁	強	衤
覆	復	襾
視	礻	見
調	⺆	言	𠮷
諸	言	者
請	言	青
謁	匂	日	言
諾	右	言	艹
諭	俞	言
謹	口	土	廿	言
變	䜌	夂
贈	八	日	田	貝
輸	俞	車
遲	辶	𫵠
醙	又	酉	𦥔
鉶	金	𠛬
陼	阝	者
難	隹	𦰩
靖	立	青
韛	韋	𤰇
響	郷	音
頋	厂	巳	頁
頻	歩	頁
鬒	真	髟
龜	龜
𢡊	夭	心	忄
𢡄	夭	忄	日
𣏕	木	朮
㮝	木	郤
䀘	幵	目
䀹	㚒	目
𥉉	丨	亻	夂	朩	目
𥳐	竹	開
𧻓	幷	走
齃	匂	日	鼻
龎	厂	龍